AAAAACTGCGAAAGACCAC -> AAAACTGCGAAAGACCACT
AAAAAGCATCTGGCCCCGA -> AAAAGCATCTGGCCCCGAT
AAAACACGCCCGAGCGGAT -> AAACACGCCCGAGCGGATA
AAAACCTAGGTACGTTATA -> AAACCTAGGTACGTTATAC
AAAACGGAGGCGGCCCTCT -> AAACGGAGGCGGCCCTCTG
AAAACTCGGTCCAGGCGAC -> AAACTCGGTCCAGGCGACA
AAAACTGCGAAAGACCACT -> AAACTGCGAAAGACCACTG
AAAAGCATCTGGCCCCGAT -> AAAGCATCTGGCCCCGATA
AAAATCAATAGGGCAGAAA -> AAATCAATAGGGCAGAAAA
AAAATCGGAATTCAAATAC -> AAATCGGAATTCAAATACA
AAAATGACTGGAAGTATTG -> AAATGACTGGAAGTATTGG
AAAATGACTGGACGACTGG -> AAATGACTGGACGACTGGC
AAAATGACTGGAGTGCCCC -> AAATGACTGGAGTGCCCCC
AAAATGACTGGATGATGGG -> AAATGACTGGATGATGGGA
AAACAATGGAAAACTCGGT -> AACAATGGAAAACTCGGTC
AAACACGCCCGAGCGGATA -> AACACGCCCGAGCGGATAT
AAACCAAAACGGAGGCGGC -> AACCAAAACGGAGGCGGCC
AAACCTAGGTACGTTATAC -> AACCTAGGTACGTTATACA
AAACGAATGTCCCTACCTC -> AACGAATGTCCCTACCTCG
AAACGCCCGCCGTTTCAAT -> AACGCCCGCCGTTTCAATG
AAACGGAGGCGGCCCTCTG -> AACGGAGGCGGCCCTCTGG
AAACGGCCAGGCCTGGGCA -> AACGGCCAGGCCTGGGCAA
AAACTCGGGTAAATCACGC -> AACTCGGGTAAATCACGCA
AAACTCGGGTACCTCTAAT -> AACTCGGGTACCTCTAATG
AAACTCGGTCCAGGCGACA -> AACTCGGTCCAGGCGACAC
AAACTGCGAAAGACCACTG -> AACTGCGAAAGACCACTGA
AAACTGCTGGCATACGGGA -> AACTGCTGGCATACGGGAT
AAACTTAGTGTAGTAGGTC -> AACTTAGTGTAGTAGGTCT
AAAGACCACTGAACGGGAT -> AAGACCACTGAACGGGATC
AAAGCATCTGGCCCCGATA -> AAGCATCTGGCCCCGATAC
AAAGCATGCGACAAGCACA -> AAGCATGCGACAAGCACAG
AAAGCCTCCTCCGCGAATG -> AAGCCTCCTCCGCGAATGA
AAAGGGCTAGCTTGAAACT -> AAGGGCTAGCTTGAAACTT
AAAGTGGCAAATCATTAGC -> AAGTGGCAAATCATTAGCC
AAAGTTGAAGTTCCGTGTT -> AAGTTGAAGTTCCGTGTTA
AAAGTTGGCACAGAAAAAC -> AAGTTGGCACAGAAAAACT
AAATACATGATTGGTAAGC -> AATACATGATTGGTAAGCG
AAATCAATAGGGCAGAAAA -> AATCAATAGGGCAGAAAAT
AAATCACGCAAAATCAATA -> AATCACGCAAAATCAATAG
AAATCATTAGCCCCGTCAA -> AATCATTAGCCCCGTCAAG
AAATCGGAATTCAAATACA -> AATCGGAATTCAAATACAT
AAATGACTGGAAGTATTGG -> AATGACTGGAAGTATTGGC
AAATGACTGGACGACTGGC -> AATGACTGGACGACTGGCT
AAATGACTGGAGTGCCCCC -> AATGACTGGAGTGCCCCCT
AAATGACTGGATGATGGGA -> AATGACTGGATGATGGGAG
AAATGTATCCTAACGCTTT -> AATGTATCCTAACGCTTTT
AAATTCCTAAGAACAAAAC -> AATTCCTAAGAACAAAACC
AAATTTACTGGAAAGCCTC -> AATTTACTGGAAAGCCTCC
AAATTTCGCAAACGAATGT -> AATTTCGCAAACGAATGTC
AACAAAACCTAGGTACGTT -> ACAAAACCTAGGTACGTTA
AACAATGGAAAACTCGGTC -> ACAATGGAAAACTCGGTCC
AACAATTTGATTTAGAGAA -> ACAATTTGATTTAGAGAAA
AACACCACGGCAGTCAGTG -> ACACCACGGCAGTCAGTGC
AACACGCCCGAGCGGATAT -> ACACGCCCGAGCGGATATG
AACAGCACCGGTGAATAGC -> ACAGCACCGGTGAATAGCG
AACAGTTTTGTTCATGGGA -> ACAGTTTTGTTCATGGGAC
AACATACTGCTACCGATGA -> ACATACTGCTACCGATGAA
AACATCCATCCCTGTCGTA -> ACATCCATCCCTGTCGTAT
AACCAAAACGGAGGCGGCC -> ACCAAAACGGAGGCGGCCC
AACCACATCAAACGCCCGC -> ACCACATCAAACGCCCGCC
AACCAGCAAGGGCCCAATC -> ACCAGCAAGGGCCCAATCG
AACCATAACCAGCAAGGGC -> ACCATAACCAGCAAGGGCC
AACCCTGACATGCAGATGG -> ACCCTGACATGCAGATGGG
AACCCTTTGGTCATACCGT -> ACCCTTTGGTCATACCGTG
AACCTAGGTACGTTATACA -> ACCTAGGTACGTTATACAG
AACGAATGTCCCTACCTCG -> ACGAATGTCCCTACCTCGT
AACGCCCGCCGTTTCAATG -> ACGCCCGCCGTTTCAATGT
AACGCTTTTCGGTGCAGTG -> ACGCTTTTCGGTGCAGTGG
AACGGAGGCGGCCCTCTGG -> ACGGAGGCGGCCCTCTGGA
AACGGCCAGGCCTGGGCAA -> ACGGCCAGGCCTGGGCAAG
AACGGGATCCAATGAGTGT -> ACGGGATCCAATGAGTGTT
AACGTAGAATCCTATTGCG -> ACGTAGAATCCTATTGCGG
AACGTATACACATGAGGTA -> ACGTATACACATGAGGTAA
AACGTGGCGCTACTAGGTT -> ACGTGGCGCTACTAGGTTA
AACGTTATCAAGAGAATCA -> ACGTTATCAAGAGAATCAC
AACTCCCTGTTCAAATTTA -> ACTCCCTGTTCAAATTTAC
AACTCGCCGATTTGCTCTG -> ACTCGCCGATTTGCTCTGG
AACTCGGGTAAATCACGCA -> ACTCGGGTAAATCACGCAA
AACTCGGGTACCTCTAATG -> ACTCGGGTACCTCTAATGG
AACTCGGTCCAGGCGACAC -> ACTCGGTCCAGGCGACACC
AACTGCGAAAGACCACTGA -> ACTGCGAAAGACCACTGAA
AACTGCTGGCATACGGGAT -> ACTGCTGGCATACGGGATT
AACTGTGCCGTGCCTGGGA -> ACTGTGCCGTGCCTGGGAG
AACTTAACGTTATCAAGAG -> ACTTAACGTTATCAAGAGA
AACTTAGTGTAGTAGGTCT -> ACTTAGTGTAGTAGGTCTC
AAGAACAAAACCTAGGTAC -> AGAACAAAACCTAGGTACG
AAGACCACTGAACGGGATC -> AGACCACTGAACGGGATCC
AAGAGAATCACAGCCGGGT -> AGAGAATCACAGCCGGGTA
AAGAGACAGGAATCTTTGT -> AGAGACAGGAATCTTTGTG
AAGATACGAAAGTTGGCAC -> AGATACGAAAGTTGGCACA
AAGATGTCCCAGGCAGAGG -> AGATGTCCCAGGCAGAGGG
AAGCACAGCCTTGCGTCTC -> AGCACAGCCTTGCGTCTCT
AAGCATCTGGCCCCGATAC -> AGCATCTGGCCCCGATACC
AAGCATGCGACAAGCACAG -> AGCATGCGACAAGCACAGC
AAGCCCGCAGGTAGAATCT -> AGCCCGCAGGTAGAATCTA
AAGCCTCCTCCGCGAATGA -> AGCCTCCTCCGCGAATGAT
AAGCGGGGGGCTTGAATGT -> AGCGGGGGGCTTGAATGTG
AAGCGTCATCGCCCCATTG -> AGCGTCATCGCCCCATTGA
AAGGAAGTCTGAGATTGGG -> AGGAAGTCTGAGATTGGGC
AAGGACGTTGAGCCCCTAC -> AGGACGTTGAGCCCCTACA
AAGGCCGTCAGCAGGTTCT -> AGGCCGTCAGCAGGTTCTA
AAGGCGAGATCAGTCGAGC -> AGGCGAGATCAGTCGAGCT
AAGGCGCGTGGGCAAAGTT -> AGGCGCGTGGGCAAAGTTG
AAGGCGGCCAACATCCATC -> AGGCGGCCAACATCCATCC
AAGGCGTTACGGATTAACA -> AGGCGTTACGGATTAACAC
AAGGGCCCAATCGCCGCGT -> AGGGCCCAATCGCCGCGTT
AAGGGCCGTGCATGGAAAG -> AGGGCCGTGCATGGAAAGC
AAGGGCTAGCTTGAAACTT -> AGGGCTAGCTTGAAACTTA
AAGGGGCTAGGGCTCGGAC -> AGGGGCTAGGGCTCGGACC
AAGGTCTCATAGCCAACTT -> AGGTCTCATAGCCAACTTA
AAGTAGCGCCAGTTGGACC -> AGTAGCGCCAGTTGGACCT
AAGTATTGGCTGCAGTTTT -> AGTATTGGCTGCAGTTTTG
AAGTCTATAAACCAAAACG -> AGTCTATAAACCAAAACGG
AAGTCTGAGATTGGGCACC -> AGTCTGAGATTGGGCACCA
AAGTGGCAAATCATTAGCC -> AGTGGCAAATCATTAGCCC
AAGTTCCGTGTTATCCACT -> AGTTCCGTGTTATCCACTA
AAGTTGAAGTTCCGTGTTA -> AGTTGAAGTTCCGTGTTAT
AAGTTGGCACAGAAAAACT -> AGTTGGCACAGAAAAACTG
AATAAACTCGGGTACCTCT -> ATAAACTCGGGTACCTCTA
AATACATGATTGGTAAGCG -> ATACATGATTGGTAAGCGT
AATACGCTCAGAGTTCAAA -> ATACGCTCAGAGTTCAAAC
AATAGCGGGGGATATCGGT -> ATAGCGGGGGATATCGGTG
AATAGGATATCAGGTATTC -> ATAGGATATCAGGTATTCG
AATAGGGCAGAAAATGACT -> ATAGGGCAGAAAATGACTG
AATCAAGGGCCGTGCATGG -> ATCAAGGGCCGTGCATGGA
AATCAATAGGGCAGAAAAT -> ATCAATAGGGCAGAAAATG
AATCACAGCCGGGTAGTGG -> ATCACAGCCGGGTAGTGGT
AATCACGCAAAATCAATAG -> ATCACGCAAAATCAATAGG
AATCAGAGAGTGAAACAAT -> ATCAGAGAGTGAAACAATG
AATCATTAGCCCCGTCAAG -> ATCATTAGCCCCGTCAAGG
AATCCTATTGCGGTAATAA -> ATCCTATTGCGGTAATAAA
AATCCTTACGACATGAAAT -> ATCCTTACGACATGAAATT
AATCGCCGCGTTTCAAGGC -> ATCGCCGCGTTTCAAGGCG
AATCGGAATTCAAATACAT -> ATCGGAATTCAAATACATG
AATCTATATTATGGGGCCC -> ATCTATATTATGGGGCCCA
AATCTCGCGGGTGCCTCAG -> ATCTCGCGGGTGCCTCAGC
AATCTGGACGAGCCTGACG -> ATCTGGACGAGCCTGACGT
AATCTTTGTGGGCTATTAT -> ATCTTTGTGGGCTATTATC
AATGACTGGAAGTATTGGC -> ATGACTGGAAGTATTGGCT
AATGACTGGACGACTGGCT -> ATGACTGGACGACTGGCTG
AATGACTGGAGTGCCCCCT -> ATGACTGGAGTGCCCCCTT
AATGACTGGATGATGGGAG -> ATGACTGGATGATGGGAGA
AATGAGTGTTTTTGAAGGA -> ATGAGTGTTTTTGAAGGAC
AATGATACGCCGTATTGAC -> ATGATACGCCGTATTGACA
AATGGAAAACTCGGTCCAG -> ATGGAAAACTCGGTCCAGG
AATGGTCTACGGGACGCCT -> ATGGTCTACGGGACGCCTT
AATGTAAGGGGCTAGGGCT -> ATGTAAGGGGCTAGGGCTC
AATGTATCCTAACGCTTTT -> ATGTATCCTAACGCTTTTC
AATGTCCCTACCTCGTACC -> ATGTCCCTACCTCGTACCG
AATGTCGAATTATTATCTC -> ATGTCGAATTATTATCTCC
AATGTGGGTGTTCAAAAAG -> ATGTGGGTGTTCAAAAAGC
AATGTTATATCCTAATGTC -> ATGTTATATCCTAATGTCG
AATTATTATCTCCAACTCG -> ATTATTATCTCCAACTCGC
AATTCAAATACATGATTGG -> ATTCAAATACATGATTGGT
AATTCCTAAGAACAAAACC -> ATTCCTAAGAACAAAACCT
AATTGACGCGGTAACCACA -> ATTGACGCGGTAACCACAT
AATTGTGTCCTATTGTGTT -> ATTGTGTCCTATTGTGTTG
AATTTACTGGAAAGCCTCC -> ATTTACTGGAAAGCCTCCT
AATTTCGCAAACGAATGTC -> ATTTCGCAAACGAATGTCC
AATTTGATTTAGAGAAATG -> ATTTGATTTAGAGAAATGT
ACAAAACCTAGGTACGTTA -> CAAAACCTAGGTACGTTAT
ACAAACGGCCAGGCCTGGG -> CAAACGGCCAGGCCTGGGC
ACAACAATTTGATTTAGAG -> CAACAATTTGATTTAGAGA
ACAAGCACAGCCTTGCGTC -> CAAGCACAGCCTTGCGTCT
ACAAGTCTATAAACCAAAA -> CAAGTCTATAAACCAAAAC
ACAATCCTTACGACATGAA -> CAATCCTTACGACATGAAA
ACAATGGAAAACTCGGTCC -> CAATGGAAAACTCGGTCCA
ACAATTTGATTTAGAGAAA -> CAATTTGATTTAGAGAAAT
ACACAAACGGCCAGGCCTG -> CACAAACGGCCAGGCCTGG
ACACATCTCAAGGTCTCAT -> CACATCTCAAGGTCTCATA
ACACATGAGGTAAATTCCT -> CACATGAGGTAAATTCCTA
ACACATGCACTCATAGCTG -> CACATGCACTCATAGCTGG
ACACCACGGCAGTCAGTGC -> CACCACGGCAGTCAGTGCG
ACACCGCAGATTCTTGGTC -> CACCGCAGATTCTTGGTCG
ACACGCCCGAGCGGATATG -> CACGCCCGAGCGGATATGT
ACACGCTAAAGGGCTAGCT -> CACGCTAAAGGGCTAGCTT
ACACTACACAAACGGCCAG -> CACTACACAAACGGCCAGG
ACACTTCGGGGGACATCAA -> CACTTCGGGGGACATCAAG
ACACTTTGAACCCTGACAT -> CACTTTGAACCCTGACATG
ACAGAAAAACTGCGAAAGA -> CAGAAAAACTGCGAAAGAC
ACAGCACCGGTGAATAGCG -> CAGCACCGGTGAATAGCGG
ACAGCCGGGTAGTGGTCGC -> CAGCCGGGTAGTGGTCGCA
ACAGCCTTGCGTCTCTAAA -> CAGCCTTGCGTCTCTAAAC
ACAGGAATCTTTGTGGGCT -> CAGGAATCTTTGTGGGCTA
ACAGGACGCACACTTCGGG -> CAGGACGCACACTTCGGGG
ACAGTTGATAGTCTTTCAA -> CAGTTGATAGTCTTTCAAC
ACAGTTGTCAACTCCCTGT -> CAGTTGTCAACTCCCTGTT
ACAGTTTTGTTCATGGGAC -> CAGTTTTGTTCATGGGACA
ACATAAGGCGCGTGGGCAA -> CATAAGGCGCGTGGGCAAA
ACATACTGCTACCGATGAA -> CATACTGCTACCGATGAAG
ACATATAGATCGTAGACAC -> CATATAGATCGTAGACACA
ACATCAAACGCCCGCCGTT -> CATCAAACGCCCGCCGTTT
ACATCAAGATGTCCCAGGC -> CATCAAGATGTCCCAGGCA
ACATCCATCCCTGTCGTAT -> CATCCATCCCTGTCGTATG
ACATCTCAAGGTCTCATAG -> CATCTCAAGGTCTCATAGC
ACATGAAATTTCGCAAACG -> CATGAAATTTCGCAAACGA
ACATGAGGTAAATTCCTAA -> CATGAGGTAAATTCCTAAG
ACATGATTGGTAAGCGTCA -> CATGATTGGTAAGCGTCAT
ACATGCACTCATAGCTGGC -> CATGCACTCATAGCTGGCG
ACATGCAGATGGGCAGAAA -> CATGCAGATGGGCAGAAAA
ACATGGGGAACTGTGCCGT -> CATGGGGAACTGTGCCGTG
ACCAAAACGGAGGCGGCCC -> CCAAAACGGAGGCGGCCCT
ACCACATAAGGCGCGTGGG -> CCACATAAGGCGCGTGGGC
ACCACATCAAACGCCCGCC -> CCACATCAAACGCCCGCCG
ACCACGGCAGTCAGTGCGA -> CCACGGCAGTCAGTGCGAC
ACCACTGAACGGGATCCAA -> CCACTGAACGGGATCCAAT
ACCAGCAAGGGCCCAATCG -> CCAGCAAGGGCCCAATCGC
ACCATAACCAGCAAGGGCC -> CCATAACCAGCAAGGGCCC
ACCATAAGGCGTTACGGAT -> CCATAAGGCGTTACGGATT
ACCCACTGGTACCTATACT -> CCCACTGGTACCTATACTC
ACCCCCGAGCGTGGAGCGT -> CCCCCGAGCGTGGAGCGTG
ACCCTGACATGCAGATGGG -> CCCTGACATGCAGATGGGC
ACCCTGGAGGGTGATTAAC -> CCCTGGAGGGTGATTAACC
ACCCTTTGGTCATACCGTG -> CCCTTTGGTCATACCGTGA
ACCGATGAAGTAGCGCCAG -> CCGATGAAGTAGCGCCAGT
ACCGATGCGGCTAGGGTTG -> CCGATGCGGCTAGGGTTGG
ACCGCAGATTCTTGGTCGG -> CCGCAGATTCTTGGTCGGA
ACCGGTGAATAGCGGGGGA -> CCGGTGAATAGCGGGGGAT
ACCGTCGGATCTAAAGTGG -> CCGTCGGATCTAAAGTGGC
ACCGTGAGGTCAGTATTGT -> CCGTGAGGTCAGTATTGTA
ACCGTGCCCTCCAAGGCGG -> CCGTGCCCTCCAAGGCGGC
ACCGTGGCTGCCCTTAATT -> CCGTGGCTGCCCTTAATTG
ACCTAGGTACGTTATACAG -> CCTAGGTACGTTATACAGG
ACCTATACTCCCGTGACCC -> CCTATACTCCCGTGACCCC
ACCTCCAAGAGACAGGAAT -> CCTCCAAGAGACAGGAATC
ACCTCCCACGTGCCGTAAG -> CCTCCCACGTGCCGTAAGC
ACCTCGTACCGATGCGGCT -> CCTCGTACCGATGCGGCTA
ACCTCTAATGGTCTACGGG -> CCTCTAATGGTCTACGGGA
ACCTGGATAATCAGAGAGT -> CCTGGATAATCAGAGAGTG
ACGAAAGTTGGCACAGAAA -> CGAAAGTTGGCACAGAAAA
ACGAATGTCCCTACCTCGT -> CGAATGTCCCTACCTCGTA
ACGACATGAAATTTCGCAA -> CGACATGAAATTTCGCAAA
ACGACTGGCTGCCAGTTTT -> CGACTGGCTGCCAGTTTTG
ACGACTGGGCTTTTAGCAT -> CGACTGGGCTTTTAGCATA
ACGAGCAAAACACGCCCGA -> CGAGCAAAACACGCCCGAG
ACGAGCCTGACGTATTAAC -> CGAGCCTGACGTATTAACA
ACGCAAAATCAATAGGGCA -> CGCAAAATCAATAGGGCAG
ACGCACACTTCGGGGGACA -> CGCACACTTCGGGGGACAT
ACGCCCGAGCGGATATGTT -> CGCCCGAGCGGATATGTTC
ACGCCCGCCGTTTCAATGT -> CGCCCGCCGTTTCAATGTA
ACGCCGTATTGACACATCT -> CGCCGTATTGACACATCTC
ACGCCTTCTGTGTGAATGT -> CGCCTTCTGTGTGAATGTT
ACGCGGTAACCACATCAAA -> CGCGGTAACCACATCAAAC
ACGCTAAAGGGCTAGCTTG -> CGCTAAAGGGCTAGCTTGA
ACGCTCAGAGTTCAAACTG -> CGCTCAGAGTTCAAACTGC
ACGCTTTTCGGTGCAGTGG -> CGCTTTTCGGTGCAGTGGC
ACGGAGGCGGCCCTCTGGA -> CGGAGGCGGCCCTCTGGAG
ACGGATTAACACCACGGCA -> CGGATTAACACCACGGCAG
ACGGCAGTCAGTGCGACCG -> CGGCAGTCAGTGCGACCGT
ACGGCCAGGCCTGGGCAAG -> CGGCCAGGCCTGGGCAAGA
ACGGGACGCCTTCTGTGTG -> CGGGACGCCTTCTGTGTGA
ACGGGATCCAATGAGTGTT -> CGGGATCCAATGAGTGTTT
ACGGGATTGATAATAGGAT -> CGGGATTGATAATAGGATA
ACGTAGAATCCTATTGCGG -> CGTAGAATCCTATTGCGGT
ACGTATACACATGAGGTAA -> CGTATACACATGAGGTAAA
ACGTATTAACAGCACCGGT -> CGTATTAACAGCACCGGTG
ACGTCAGCAACGTATACAC -> CGTCAGCAACGTATACACA
ACGTGCCGTAAGCCCGCAG -> CGTGCCGTAAGCCCGCAGG
ACGTGGCGCTACTAGGTTA -> CGTGGCGCTACTAGGTTAA
ACGTTATACAGGACGCACA -> CGTTATACAGGACGCACAC
ACGTTATCAAGAGAATCAC -> CGTTATCAAGAGAATCACA
ACGTTGAGCCCCTACAAGT -> CGTTGAGCCCCTACAAGTC
ACTACACAAACGGCCAGGC -> CTACACAAACGGCCAGGCC
ACTACAGTTGTCAACTCCC -> CTACAGTTGTCAACTCCCT
ACTAGGTTAACATACTGCT -> CTAGGTTAACATACTGCTA
ACTATCGCGGATCCAGCTC -> CTATCGCGGATCCAGCTCC
ACTCATAGCTGGCGCGAGC -> CTCATAGCTGGCGCGAGCG
ACTCCCGTGACCCCCGAGC -> CTCCCGTGACCCCCGAGCG
ACTCCCTGTTCAAATTTAC -> CTCCCTGTTCAAATTTACT
ACTCGCCGATTTGCTCTGG -> CTCGCCGATTTGCTCTGGA
ACTCGGGTAAATCACGCAA -> CTCGGGTAAATCACGCAAA
ACTCGGGTACCTCTAATGG -> CTCGGGTACCTCTAATGGT
ACTCGGTCCAGGCGACACC -> CTCGGTCCAGGCGACACCG
ACTGAACGGGATCCAATGA -> CTGAACGGGATCCAATGAG
ACTGCGAAAGACCACTGAA -> CTGCGAAAGACCACTGAAC
ACTGCTACCGATGAAGTAG -> CTGCTACCGATGAAGTAGC
ACTGCTGGCATACGGGATT -> CTGCTGGCATACGGGATTG
ACTGGAAAGCCTCCTCCGC -> CTGGAAAGCCTCCTCCGCG
ACTGGAAGTATTGGCTGCA -> CTGGAAGTATTGGCTGCAG
ACTGGACGACTGGCTGCCA -> CTGGACGACTGGCTGCCAG
ACTGGAGTGCCCCCTTTCA -> CTGGAGTGCCCCCTTTCAG
ACTGGATGATGGGAGAACA -> CTGGATGATGGGAGAACAG
ACTGGCTGCCAGTTTTGTT -> CTGGCTGCCAGTTTTGTTC
ACTGGGCTTTTAGCATAGT -> CTGGGCTTTTAGCATAGTC
ACTGGTACCTATACTCCCG -> CTGGTACCTATACTCCCGT
ACTGTGATGTGTCAGATGC -> CTGTGATGTGTCAGATGCA
ACTGTGCCGTGCCTGGGAG -> CTGTGCCGTGCCTGGGAGG
ACTTAACGTTATCAAGAGA -> CTTAACGTTATCAAGAGAA
ACTTAGTGTAGTAGGTCTC -> CTTAGTGTAGTAGGTCTCG
ACTTCGGGGGACATCAAGA -> CTTCGGGGGACATCAAGAT
ACTTTGAACCCTGACATGC -> CTTTGAACCCTGACATGCA
AGAAAAACTGCGAAAGACC -> GAAAAACTGCGAAAGACCA
AGAAAATGACTGGAAGTAT -> GAAAATGACTGGAAGTATT
AGAAAATGACTGGACGACT -> GAAAATGACTGGACGACTG
AGAAAATGACTGGAGTGCC -> GAAAATGACTGGAGTGCCC
AGAAAATGACTGGATGATG -> GAAAATGACTGGATGATGG
AGAAATGTATCCTAACGCT -> GAAATGTATCCTAACGCTT
AGAACAAAACCTAGGTACG -> GAACAAAACCTAGGTACGT
AGAACAGTTTTGTTCATGG -> GAACAGTTTTGTTCATGGG
AGAATCACAGCCGGGTAGT -> GAATCACAGCCGGGTAGTG
AGAATCCTATTGCGGTAAT -> GAATCCTATTGCGGTAATA
AGAATCTATATTATGGGGC -> GAATCTATATTATGGGGCC
AGACACATGCACTCATAGC -> GACACATGCACTCATAGCT
AGACAGGAATCTTTGTGGG -> GACAGGAATCTTTGTGGGC
AGACCACTGAACGGGATCC -> GACCACTGAACGGGATCCA
AGAGAAATGTATCCTAACG -> GAGAAATGTATCCTAACGC
AGAGAATCACAGCCGGGTA -> GAGAATCACAGCCGGGTAG
AGAGACAGGAATCTTTGTG -> GAGACAGGAATCTTTGTGG
AGAGAGTGAAACAATGGAA -> GAGAGTGAAACAATGGAAA
AGAGGGTTATGCGGCTAAC -> GAGGGTTATGCGGCTAACG
AGAGTGAAACAATGGAAAA -> GAGTGAAACAATGGAAAAC
AGAGTTCAAACTGCTGGCA -> GAGTTCAAACTGCTGGCAT
AGATACGAAAGTTGGCACA -> GATACGAAAGTTGGCACAG
AGATCAGTCGAGCTTTCTA -> GATCAGTCGAGCTTTCTAG
AGATCGTAGACACATGCAC -> GATCGTAGACACATGCACT
AGATGCAAGGCCGTCAGCA -> GATGCAAGGCCGTCAGCAG
AGATGGGCAGAAAATGACT -> GATGGGCAGAAAATGACTG
AGATGTCCCAGGCAGAGGG -> GATGTCCCAGGCAGAGGGT
AGATTCTTGGTCGGACACG -> GATTCTTGGTCGGACACGC
AGATTGGGCACCACATAAG -> GATTGGGCACCACATAAGG
AGCAAAACACGCCCGAGCG -> GCAAAACACGCCCGAGCGG
AGCAACGTATACACATGAG -> GCAACGTATACACATGAGG
AGCAAGGGCCCAATCGCCG -> GCAAGGGCCCAATCGCCGC
AGCACAGCCTTGCGTCTCT -> GCACAGCCTTGCGTCTCTA
AGCACCGGTGAATAGCGGG -> GCACCGGTGAATAGCGGGG
AGCACGACTGGGCTTTTAG -> GCACGACTGGGCTTTTAGC
AGCAGGTTCTACCGTGCCC -> GCAGGTTCTACCGTGCCCT
AGCATAGTCCACGAGCAAA -> GCATAGTCCACGAGCAAAA
AGCATCTGGCCCCGATACC -> GCATCTGGCCCCGATACCG
AGCATGCGACAAGCACAGC -> GCATGCGACAAGCACAGCC
AGCATTGCCTTTGTCTCCT -> GCATTGCCTTTGTCTCCTG
AGCCAACTTAACGTTATCA -> GCCAACTTAACGTTATCAA
AGCCAATTGTGTCCTATTG -> GCCAATTGTGTCCTATTGT
AGCCCCGTCAAGGAAGTCT -> GCCCCGTCAAGGAAGTCTG
AGCCCCTACAAGTCTATAA -> GCCCCTACAAGTCTATAAA
AGCCCGCAGGTAGAATCTA -> GCCCGCAGGTAGAATCTAT
AGCCCGTCCTATGACATGG -> GCCCGTCCTATGACATGGG
AGCCGGGTAGTGGTCGCAT -> GCCGGGTAGTGGTCGCATG
AGCCTCCTCCGCGAATGAT -> GCCTCCTCCGCGAATGATA
AGCCTGACGTATTAACAGC -> GCCTGACGTATTAACAGCA
AGCCTTGCGTCTCTAAACT -> GCCTTGCGTCTCTAAACTC
AGCGCCAGTTGGACCTCCC -> GCGCCAGTTGGACCTCCCA
AGCGGATATGTTCTGAGCA -> GCGGATATGTTCTGAGCAT
AGCGGGAGTACCCACTGGT -> GCGGGAGTACCCACTGGTA
AGCGGGCAGAAAATGACTG -> GCGGGCAGAAAATGACTGG
AGCGGGGGATATCGGTGGG -> GCGGGGGATATCGGTGGGG
AGCGGGGGGCTTGAATGTG -> GCGGGGGGCTTGAATGTGG
AGCGTCATCGCCCCATTGA -> GCGTCATCGCCCCATTGAA
AGCGTGCCCAGGTACAATC -> GCGTGCCCAGGTACAATCC
AGCGTGGAGCGTGCCCAGG -> GCGTGGAGCGTGCCCAGGT
AGCTAGGGCTACCCTGGAG -> GCTAGGGCTACCCTGGAGG
AGCTCCCTTGGACACTTTG -> GCTCCCTTGGACACTTTGA
AGCTGGCGCGAGCGGGAGT -> GCTGGCGCGAGCGGGAGTA
AGCTTGAAACTTAGTGTAG -> GCTTGAAACTTAGTGTAGT
AGCTTTCTAGCACGACTGG -> GCTTTCTAGCACGACTGGG
AGGAAGTCTGAGATTGGGC -> GGAAGTCTGAGATTGGGCA
AGGAATCTTTGTGGGCTAT -> GGAATCTTTGTGGGCTATT
AGGACGCACACTTCGGGGG -> GGACGCACACTTCGGGGGA
AGGACGTTGAGCCCCTACA -> GGACGTTGAGCCCCTACAA
AGGATATCAGGTATTCGCC -> GGATATCAGGTATTCGCCC
AGGCAGAGGGTTATGCGGC -> GGCAGAGGGTTATGCGGCT
AGGCCGTCAGCAGGTTCTA -> GGCCGTCAGCAGGTTCTAC
AGGCCTGGGCAAGATACGA -> GGCCTGGGCAAGATACGAA
AGGCGACACCGCAGATTCT -> GGCGACACCGCAGATTCTT
AGGCGAGATCAGTCGAGCT -> GGCGAGATCAGTCGAGCTT
AGGCGCGTGGGCAAAGTTG -> GGCGCGTGGGCAAAGTTGA
AGGCGGCCAACATCCATCC -> GGCGGCCAACATCCATCCC
AGGCGGCCCTCTGGAGGGA -> GGCGGCCCTCTGGAGGGAC
AGGCGTTACGGATTAACAC -> GGCGTTACGGATTAACACC
AGGGACCTCCAAGAGACAG -> GGGACCTCCAAGAGACAGG
AGGGCAGAAAATGACTGGA -> GGGCAGAAAATGACTGGAA
AGGGCCCAATCGCCGCGTT -> GGGCCCAATCGCCGCGTTT
AGGGCCGTGCATGGAAAGC -> GGGCCGTGCATGGAAAGCA
AGGGCTACCCTGGAGGGTG -> GGGCTACCCTGGAGGGTGA
AGGGCTAGCTTGAAACTTA -> GGGCTAGCTTGAAACTTAG
AGGGCTCGGACCTGGATAA -> GGGCTCGGACCTGGATAAT
AGGGGCTAGGGCTCGGACC -> GGGGCTAGGGCTCGGACCT
AGGGGCTCTCACGTCAGCA -> GGGGCTCTCACGTCAGCAA
AGGGTGATTAACCATAACC -> GGGTGATTAACCATAACCA
AGGGTTATGCGGCTAACGT -> GGGTTATGCGGCTAACGTG
AGGGTTGGCTGGACCATAA -> GGGTTGGCTGGACCATAAG
AGGTAAATTCCTAAGAACA -> GGTAAATTCCTAAGAACAA
AGGTACAATCCTTACGACA -> GGTACAATCCTTACGACAT
AGGTACGTTATACAGGACG -> GGTACGTTATACAGGACGC
AGGTAGAATCTATATTATG -> GGTAGAATCTATATTATGG
AGGTATTCGCCCTTAATCA -> GGTATTCGCCCTTAATCAA
AGGTCAGTATTGTAGCCCG -> GGTCAGTATTGTAGCCCGT
AGGTCTCATAGCCAACTTA -> GGTCTCATAGCCAACTTAA
AGGTCTCGGATCTGGGAAA -> GGTCTCGGATCTGGGAAAA
AGGTGCGTCAATCTGGACG -> GGTGCGTCAATCTGGACGA
AGGTTAACATACTGCTACC -> GGTTAACATACTGCTACCG
AGGTTCTACCGTGCCCTCC -> GGTTCTACCGTGCCCTCCA
AGTACCCACTGGTACCTAT -> GTACCCACTGGTACCTATA
AGTAGCGCCAGTTGGACCT -> GTAGCGCCAGTTGGACCTC
AGTAGGTCTCGGATCTGGG -> GTAGGTCTCGGATCTGGGA
AGTATTGGCTGCAGTTTTG -> GTATTGGCTGCAGTTTTGT
AGTATTGTAGCCCGTCCTA -> GTATTGTAGCCCGTCCTAT
AGTCAGTGCGACCGTCGGA -> GTCAGTGCGACCGTCGGAT
AGTCCACGAGCAAAACACG -> GTCCACGAGCAAAACACGC
AGTCGAGCTTTCTAGCACG -> GTCGAGCTTTCTAGCACGA
AGTCTATAAACCAAAACGG -> GTCTATAAACCAAAACGGA
AGTCTGAGATTGGGCACCA -> GTCTGAGATTGGGCACCAC
AGTCTTTCAACGTAGAATC -> GTCTTTCAACGTAGAATCC
AGTGAAACAATGGAAAACT -> GTGAAACAATGGAAAACTC
AGTGCCCCCTTTCAGTTTT -> GTGCCCCCTTTCAGTTTTG
AGTGCGACCGTCGGATCTA -> GTGCGACCGTCGGATCTAA
AGTGGCAAATCATTAGCCC -> GTGGCAAATCATTAGCCCC
AGTGGCCAAGCGGGGGGCT -> GTGGCCAAGCGGGGGGCTT
AGTGGTCGCATGGCGCTCC -> GTGGTCGCATGGCGCTCCA
AGTGTAGTAGGTCTCGGAT -> GTGTAGTAGGTCTCGGATC
AGTGTTTTTGAAGGACGTT -> GTGTTTTTGAAGGACGTTG
AGTTCAAACTGCTGGCATA -> GTTCAAACTGCTGGCATAC
AGTTCCGTGTTATCCACTA -> GTTCCGTGTTATCCACTAT
AGTTGAAGTTCCGTGTTAT -> GTTGAAGTTCCGTGTTATC
AGTTGATAGTCTTTCAACG -> GTTGATAGTCTTTCAACGT
AGTTGGACCTCCCACGTGC -> GTTGGACCTCCCACGTGCC
AGTTGGCACAGAAAAACTG -> GTTGGCACAGAAAAACTGC
AGTTGTCAACTCCCTGTTC -> GTTGTCAACTCCCTGTTCA
AGTTTTGTTCATGGGACAA -> GTTTTGTTCATGGGACAAC
AGTTTTGTTCATGGGACAC -> GTTTTGTTCATGGGACACT
AGTTTTGTTCATGGGACAG -> GTTTTGTTCATGGGACAGT
AGTTTTGTTCATGGGACAT -> GTTTTGTTCATGGGACATA
ATAAACCAAAACGGAGGCG -> TAAACCAAAACGGAGGCGG
ATAAACTCGGGTACCTCTA -> TAAACTCGGGTACCTCTAA
ATAACCAGCAAGGGCCCAA -> TAACCAGCAAGGGCCCAAT
ATAAGGCGCGTGGGCAAAG -> TAAGGCGCGTGGGCAAAGT
ATAAGGCGTTACGGATTAA -> TAAGGCGTTACGGATTAAC
ATAATAGGATATCAGGTAT -> TAATAGGATATCAGGTATT
ATAATCAGAGAGTGAAACA -> TAATCAGAGAGTGAAACAA
ATACACATGAGGTAAATTC -> TACACATGAGGTAAATTCC
ATACAGGACGCACACTTCG -> TACAGGACGCACACTTCGG
ATACATGATTGGTAAGCGT -> TACATGATTGGTAAGCGTC
ATACCGTGAGGTCAGTATT -> TACCGTGAGGTCAGTATTG
ATACCGTGGCTGCCCTTAA -> TACCGTGGCTGCCCTTAAT
ATACGAAAGTTGGCACAGA -> TACGAAAGTTGGCACAGAA
ATACGCCGTATTGACACAT -> TACGCCGTATTGACACATC
ATACGCTCAGAGTTCAAAC -> TACGCTCAGAGTTCAAACT
ATACGGGATTGATAATAGG -> TACGGGATTGATAATAGGA
ATACTCCCGTGACCCCCGA -> TACTCCCGTGACCCCCGAG
ATACTGCTACCGATGAAGT -> TACTGCTACCGATGAAGTA
ATAGATCGTAGACACATGC -> TAGATCGTAGACACATGCA
ATAGCCAACTTAACGTTAT -> TAGCCAACTTAACGTTATC
ATAGCGGGGGATATCGGTG -> TAGCGGGGGATATCGGTGG
ATAGCTAGGGCTACCCTGG -> TAGCTAGGGCTACCCTGGA
ATAGCTGGCGCGAGCGGGA -> TAGCTGGCGCGAGCGGGAG
ATAGGATATCAGGTATTCG -> TAGGATATCAGGTATTCGC
ATAGGGCAGAAAATGACTG -> TAGGGCAGAAAATGACTGG
ATAGTCCACGAGCAAAACA -> TAGTCCACGAGCAAAACAC
ATAGTCTTTCAACGTAGAA -> TAGTCTTTCAACGTAGAAT
ATATAGATCGTAGACACAT -> TATAGATCGTAGACACATG
ATATCAGGTATTCGCCCTT -> TATCAGGTATTCGCCCTTA
ATATCCTAATGTCGAATTA -> TATCCTAATGTCGAATTAT
ATATCGGTGGGGCATCTGC -> TATCGGTGGGGCATCTGCT
ATATGTTCTGAGCATTGCC -> TATGTTCTGAGCATTGCCT
ATATTATGGGGCCCATATT -> TATTATGGGGCCCATATTC
ATATTCTGGGTCACTACAG -> TATTCTGGGTCACTACAGT
ATCAAACGCCCGCCGTTTC -> TCAAACGCCCGCCGTTTCA
ATCAAGAGAATCACAGCCG -> TCAAGAGAATCACAGCCGG
ATCAAGATGTCCCAGGCAG -> TCAAGATGTCCCAGGCAGA
ATCAAGGGCCGTGCATGGA -> TCAAGGGCCGTGCATGGAA
ATCAATAGGGCAGAAAATG -> TCAATAGGGCAGAAAATGA
ATCACAGCCGGGTAGTGGT -> TCACAGCCGGGTAGTGGTC
ATCACGCAAAATCAATAGG -> TCACGCAAAATCAATAGGG
ATCAGAGAGTGAAACAATG -> TCAGAGAGTGAAACAATGG
ATCAGGTATTCGCCCTTAA -> TCAGGTATTCGCCCTTAAT
ATCAGTCGAGCTTTCTAGC -> TCAGTCGAGCTTTCTAGCA
ATCATTAGCCCCGTCAAGG -> TCATTAGCCCCGTCAAGGA
ATCCAATGAGTGTTTTTGA -> TCCAATGAGTGTTTTTGAA
ATCCACTATCGCGGATCCA -> TCCACTATCGCGGATCCAG
ATCCAGCTCCCTTGGACAC -> TCCAGCTCCCTTGGACACT
ATCCATCCCTGTCGTATGC -> TCCATCCCTGTCGTATGCC
ATCCCTGTCGTATGCCATC -> TCCCTGTCGTATGCCATCC
ATCCTAACGCTTTTCGGTG -> TCCTAACGCTTTTCGGTGC
ATCCTAATGTCGAATTATT -> TCCTAATGTCGAATTATTA
ATCCTATTGCGGTAATAAA -> TCCTATTGCGGTAATAAAC
ATCCTTACGACATGAAATT -> TCCTTACGACATGAAATTT
ATCCTTCTGATAGCTAGGG -> TCCTTCTGATAGCTAGGGC
ATCGCCCCATTGAATACGC -> TCGCCCCATTGAATACGCT
ATCGCCGCGTTTCAAGGCG -> TCGCCGCGTTTCAAGGCGA
ATCGCGGATCCAGCTCCCT -> TCGCGGATCCAGCTCCCTT
ATCGGAATTCAAATACATG -> TCGGAATTCAAATACATGA
ATCGGGGCAGAAAATGACT -> TCGGGGCAGAAAATGACTG
ATCGGTGGGGCATCTGCTT -> TCGGTGGGGCATCTGCTTA
ATCGTAGACACATGCACTC -> TCGTAGACACATGCACTCA
ATCGTCAGCCAATTGTGTC -> TCGTCAGCCAATTGTGTCC
ATCTAAAGTGGCAAATCAT -> TCTAAAGTGGCAAATCATT
ATCTATATTATGGGGCCCA -> TCTATATTATGGGGCCCAT
ATCTCAAGGTCTCATAGCC -> TCTCAAGGTCTCATAGCCA
ATCTCCAACTCGCCGATTT -> TCTCCAACTCGCCGATTTG
ATCTCGCGGGTGCCTCAGC -> TCTCGCGGGTGCCTCAGCG
ATCTGCTTACTGTGATGTG -> TCTGCTTACTGTGATGTGT
ATCTGGACGAGCCTGACGT -> TCTGGACGAGCCTGACGTA
ATCTGGCCCCGATACCGTG -> TCTGGCCCCGATACCGTGG
ATCTGGGAAAATCGGAATT -> TCTGGGAAAATCGGAATTC
ATCTTTGTGGGCTATTATC -> TCTTTGTGGGCTATTATCG
ATGAAATTTCGCAAACGAA -> TGAAATTTCGCAAACGAAT
ATGAAGTAGCGCCAGTTGG -> TGAAGTAGCGCCAGTTGGA
ATGACATGGGGAACTGTGC -> TGACATGGGGAACTGTGCC
ATGACTGGAAGTATTGGCT -> TGACTGGAAGTATTGGCTG
ATGACTGGACGACTGGCTG -> TGACTGGACGACTGGCTGC
ATGACTGGAGTGCCCCCTT -> TGACTGGAGTGCCCCCTTT
ATGACTGGATGATGGGAGA -> TGACTGGATGATGGGAGAA
ATGAGGTAAATTCCTAAGA -> TGAGGTAAATTCCTAAGAA
ATGAGTGTTTTTGAAGGAC -> TGAGTGTTTTTGAAGGACG
ATGATACGCCGTATTGACA -> TGATACGCCGTATTGACAC
ATGATGGGAGAACAGTTTT -> TGATGGGAGAACAGTTTTG
ATGATTGGTAAGCGTCATC -> TGATTGGTAAGCGTCATCG
ATGCAAGGCCGTCAGCAGG -> TGCAAGGCCGTCAGCAGGT
ATGCACTCATAGCTGGCGC -> TGCACTCATAGCTGGCGCG
ATGCAGATGGGCAGAAAAT -> TGCAGATGGGCAGAAAATG
ATGCCATCCTTCTGATAGC -> TGCCATCCTTCTGATAGCT
ATGCGACAAGCACAGCCTT -> TGCGACAAGCACAGCCTTG
ATGCGGCTAACGTGGCGCT -> TGCGGCTAACGTGGCGCTA
ATGCGGCTAGGGTTGGCTG -> TGCGGCTAGGGTTGGCTGG
ATGGAAAACTCGGTCCAGG -> TGGAAAACTCGGTCCAGGC
ATGGAAAGCATGCGACAAG -> TGGAAAGCATGCGACAAGC
ATGGCGCTCCATCGGGGCA -> TGGCGCTCCATCGGGGCAG
ATGGGACAACAATTTGATT -> TGGGACAACAATTTGATTT
ATGGGACACTACACAAACG -> TGGGACACTACACAAACGG
ATGGGACAGTTGATAGTCT -> TGGGACAGTTGATAGTCTT
ATGGGACATATAGATCGTA -> TGGGACATATAGATCGTAG
ATGGGAGAACAGTTTTGTT -> TGGGAGAACAGTTTTGTTC
ATGGGCAGAAAATGACTGG -> TGGGCAGAAAATGACTGGA
ATGGGGAACTGTGCCGTGC -> TGGGGAACTGTGCCGTGCC
ATGGGGCCCATATTCTGGG -> TGGGGCCCATATTCTGGGT
ATGGTCTACGGGACGCCTT -> TGGTCTACGGGACGCCTTC
ATGTAAGGGGCTAGGGCTC -> TGTAAGGGGCTAGGGCTCG
ATGTATCCTAACGCTTTTC -> TGTATCCTAACGCTTTTCG
ATGTCCCAGGCAGAGGGTT -> TGTCCCAGGCAGAGGGTTA
ATGTCCCTACCTCGTACCG -> TGTCCCTACCTCGTACCGA
ATGTCGAATTATTATCTCC -> TGTCGAATTATTATCTCCA
ATGTGGGTGTTCAAAAAGC -> TGTGGGTGTTCAAAAAGCA
ATGTGTCAGATGCAAGGCC -> TGTGTCAGATGCAAGGCCG
ATGTTATATCCTAATGTCG -> TGTTATATCCTAATGTCGA
ATGTTCTGAGCATTGCCTT -> TGTTCTGAGCATTGCCTTT
ATTAACACCACGGCAGTCA -> TTAACACCACGGCAGTCAG
ATTAACAGCACCGGTGAAT -> TTAACAGCACCGGTGAATA
ATTAACCATAACCAGCAAG -> TTAACCATAACCAGCAAGG
ATTAGCCCCGTCAAGGAAG -> TTAGCCCCGTCAAGGAAGT
ATTATCTCCAACTCGCCGA -> TTATCTCCAACTCGCCGAT
ATTATGGGGCCCATATTCT -> TTATGGGGCCCATATTCTG
ATTATTATCTCCAACTCGC -> TTATTATCTCCAACTCGCC
ATTCAAATACATGATTGGT -> TTCAAATACATGATTGGTA
ATTCCTAAGAACAAAACCT -> TTCCTAAGAACAAAACCTA
ATTCGCCCTTAATCAAGGG -> TTCGCCCTTAATCAAGGGC
ATTCTGGGTCACTACAGTT -> TTCTGGGTCACTACAGTTG
ATTCTTGGTCGGACACGCT -> TTCTTGGTCGGACACGCTA
ATTGAATACGCTCAGAGTT -> TTGAATACGCTCAGAGTTC
ATTGACACATCTCAAGGTC -> TTGACACATCTCAAGGTCT
ATTGACGCGGTAACCACAT -> TTGACGCGGTAACCACATC
ATTGATAATAGGATATCAG -> TTGATAATAGGATATCAGG
ATTGCCTTTGTCTCCTGTA -> TTGCCTTTGTCTCCTGTAT
ATTGCGGTAATAAACTCGG -> TTGCGGTAATAAACTCGGG
ATTGGCTGCAGTTTTGTTC -> TTGGCTGCAGTTTTGTTCA
ATTGGGCACCACATAAGGC -> TTGGGCACCACATAAGGCG
ATTGGTAAGCGTCATCGCC -> TTGGTAAGCGTCATCGCCC
ATTGTAGCCCGTCCTATGA -> TTGTAGCCCGTCCTATGAC
ATTGTGTCCTATTGTGTTG -> TTGTGTCCTATTGTGTTGG
ATTGTGTTGGAATCTCGCG -> TTGTGTTGGAATCTCGCGG
ATTTACTGGAAAGCCTCCT -> TTTACTGGAAAGCCTCCTC
ATTTAGAGAAATGTATCCT -> TTTAGAGAAATGTATCCTA
ATTTCGCAAACGAATGTCC -> TTTCGCAAACGAATGTCCC
ATTTGATTTAGAGAAATGT -> TTTGATTTAGAGAAATGTA
ATTTGCTCTGGAGGTGCGT -> TTTGCTCTGGAGGTGCGTC
CAAAAAGCATCTGGCCCCG -> AAAAAGCATCTGGCCCCGA
CAAAACACGCCCGAGCGGA -> AAAACACGCCCGAGCGGAT
CAAAACCTAGGTACGTTAT -> AAAACCTAGGTACGTTATA
CAAAACGGAGGCGGCCCTC -> AAAACGGAGGCGGCCCTCT
CAAAATCAATAGGGCAGAA -> AAAATCAATAGGGCAGAAA
CAAACGAATGTCCCTACCT -> AAACGAATGTCCCTACCTC
CAAACGCCCGCCGTTTCAA -> AAACGCCCGCCGTTTCAAT
CAAACGGCCAGGCCTGGGC -> AAACGGCCAGGCCTGGGCA
CAAACTGCTGGCATACGGG -> AAACTGCTGGCATACGGGA
CAAAGTTGAAGTTCCGTGT -> AAAGTTGAAGTTCCGTGTT
CAAATACATGATTGGTAAG -> AAATACATGATTGGTAAGC
CAAATCATTAGCCCCGTCA -> AAATCATTAGCCCCGTCAA
CAAATTTACTGGAAAGCCT -> AAATTTACTGGAAAGCCTC
CAACAATTTGATTTAGAGA -> AACAATTTGATTTAGAGAA
CAACATCCATCCCTGTCGT -> AACATCCATCCCTGTCGTA
CAACCCTTTGGTCATACCG -> AACCCTTTGGTCATACCGT
CAACGTAGAATCCTATTGC -> AACGTAGAATCCTATTGCG
CAACGTATACACATGAGGT -> AACGTATACACATGAGGTA
CAACTCCCTGTTCAAATTT -> AACTCCCTGTTCAAATTTA
CAACTCGCCGATTTGCTCT -> AACTCGCCGATTTGCTCTG
CAACTTAACGTTATCAAGA -> AACTTAACGTTATCAAGAG
CAAGAGAATCACAGCCGGG -> AAGAGAATCACAGCCGGGT
CAAGAGACAGGAATCTTTG -> AAGAGACAGGAATCTTTGT
CAAGATACGAAAGTTGGCA -> AAGATACGAAAGTTGGCAC
CAAGATGTCCCAGGCAGAG -> AAGATGTCCCAGGCAGAGG
CAAGCACAGCCTTGCGTCT -> AAGCACAGCCTTGCGTCTC
CAAGCGGGGGGCTTGAATG -> AAGCGGGGGGCTTGAATGT
CAAGGAAGTCTGAGATTGG -> AAGGAAGTCTGAGATTGGG
CAAGGCCGTCAGCAGGTTC -> AAGGCCGTCAGCAGGTTCT
CAAGGCGAGATCAGTCGAG -> AAGGCGAGATCAGTCGAGC
CAAGGCGGCCAACATCCAT -> AAGGCGGCCAACATCCATC
CAAGGGCCCAATCGCCGCG -> AAGGGCCCAATCGCCGCGT
CAAGGGCCGTGCATGGAAA -> AAGGGCCGTGCATGGAAAG
CAAGGTCTCATAGCCAACT -> AAGGTCTCATAGCCAACTT
CAAGTCTATAAACCAAAAC -> AAGTCTATAAACCAAAACG
CAATAGGGCAGAAAATGAC -> AATAGGGCAGAAAATGACT
CAATCCTTACGACATGAAA -> AATCCTTACGACATGAAAT
CAATCGCCGCGTTTCAAGG -> AATCGCCGCGTTTCAAGGC
CAATCTGGACGAGCCTGAC -> AATCTGGACGAGCCTGACG
CAATGAGTGTTTTTGAAGG -> AATGAGTGTTTTTGAAGGA
CAATGGAAAACTCGGTCCA -> AATGGAAAACTCGGTCCAG
CAATGTAAGGGGCTAGGGC -> AATGTAAGGGGCTAGGGCT
CAATTGTGTCCTATTGTGT -> AATTGTGTCCTATTGTGTT
CAATTTGATTTAGAGAAAT -> AATTTGATTTAGAGAAATG
CACAAACGGCCAGGCCTGG -> ACAAACGGCCAGGCCTGGG
CACACTTCGGGGGACATCA -> ACACTTCGGGGGACATCAA
CACAGAAAAACTGCGAAAG -> ACAGAAAAACTGCGAAAGA
CACAGCCGGGTAGTGGTCG -> ACAGCCGGGTAGTGGTCGC
CACAGCCTTGCGTCTCTAA -> ACAGCCTTGCGTCTCTAAA
CACATAAGGCGCGTGGGCA -> ACATAAGGCGCGTGGGCAA
CACATCAAACGCCCGCCGT -> ACATCAAACGCCCGCCGTT
CACATCTCAAGGTCTCATA -> ACATCTCAAGGTCTCATAG
CACATGAGGTAAATTCCTA -> ACATGAGGTAAATTCCTAA
CACATGCACTCATAGCTGG -> ACATGCACTCATAGCTGGC
CACCACATAAGGCGCGTGG -> ACCACATAAGGCGCGTGGG
CACCACGGCAGTCAGTGCG -> ACCACGGCAGTCAGTGCGA
CACCGCAGATTCTTGGTCG -> ACCGCAGATTCTTGGTCGG
CACCGGTGAATAGCGGGGG -> ACCGGTGAATAGCGGGGGA
CACGACTGGGCTTTTAGCA -> ACGACTGGGCTTTTAGCAT
CACGAGCAAAACACGCCCG -> ACGAGCAAAACACGCCCGA
CACGCAAAATCAATAGGGC -> ACGCAAAATCAATAGGGCA
CACGCCCGAGCGGATATGT -> ACGCCCGAGCGGATATGTT
CACGCTAAAGGGCTAGCTT -> ACGCTAAAGGGCTAGCTTG
CACGGCAGTCAGTGCGACC -> ACGGCAGTCAGTGCGACCG
CACGTCAGCAACGTATACA -> ACGTCAGCAACGTATACAC
CACGTGCCGTAAGCCCGCA -> ACGTGCCGTAAGCCCGCAG
CACTACACAAACGGCCAGG -> ACTACACAAACGGCCAGGC
CACTACAGTTGTCAACTCC -> ACTACAGTTGTCAACTCCC
CACTATCGCGGATCCAGCT -> ACTATCGCGGATCCAGCTC
CACTCATAGCTGGCGCGAG -> ACTCATAGCTGGCGCGAGC
CACTGAACGGGATCCAATG -> ACTGAACGGGATCCAATGA
CACTGGTACCTATACTCCC -> ACTGGTACCTATACTCCCG
CACTTCGGGGGACATCAAG -> ACTTCGGGGGACATCAAGA
CACTTTGAACCCTGACATG -> ACTTTGAACCCTGACATGC
CAGAAAAACTGCGAAAGAC -> AGAAAAACTGCGAAAGACC
CAGAAAATGACTGGAAGTA -> AGAAAATGACTGGAAGTAT
CAGAAAATGACTGGACGAC -> AGAAAATGACTGGACGACT
CAGAAAATGACTGGAGTGC -> AGAAAATGACTGGAGTGCC
CAGAAAATGACTGGATGAT -> AGAAAATGACTGGATGATG
CAGAGAGTGAAACAATGGA -> AGAGAGTGAAACAATGGAA
CAGAGGGTTATGCGGCTAA -> AGAGGGTTATGCGGCTAAC
CAGAGTTCAAACTGCTGGC -> AGAGTTCAAACTGCTGGCA
CAGATGCAAGGCCGTCAGC -> AGATGCAAGGCCGTCAGCA
CAGATGGGCAGAAAATGAC -> AGATGGGCAGAAAATGACT
CAGATTCTTGGTCGGACAC -> AGATTCTTGGTCGGACACG
CAGCAACGTATACACATGA -> AGCAACGTATACACATGAG
CAGCAAGGGCCCAATCGCC -> AGCAAGGGCCCAATCGCCG
CAGCACCGGTGAATAGCGG -> AGCACCGGTGAATAGCGGG
CAGCAGGTTCTACCGTGCC -> AGCAGGTTCTACCGTGCCC
CAGCCAATTGTGTCCTATT -> AGCCAATTGTGTCCTATTG
CAGCCGGGTAGTGGTCGCA -> AGCCGGGTAGTGGTCGCAT
CAGCCTTGCGTCTCTAAAC -> AGCCTTGCGTCTCTAAACT
CAGCGGGCAGAAAATGACT -> AGCGGGCAGAAAATGACTG
CAGCTCCCTTGGACACTTT -> AGCTCCCTTGGACACTTTG
CAGGAATCTTTGTGGGCTA -> AGGAATCTTTGTGGGCTAT
CAGGACGCACACTTCGGGG -> AGGACGCACACTTCGGGGG
CAGGCAGAGGGTTATGCGG -> AGGCAGAGGGTTATGCGGC
CAGGCCTGGGCAAGATACG -> AGGCCTGGGCAAGATACGA
CAGGCGACACCGCAGATTC -> AGGCGACACCGCAGATTCT
CAGGTACAATCCTTACGAC -> AGGTACAATCCTTACGACA
CAGGTAGAATCTATATTAT -> AGGTAGAATCTATATTATG
CAGGTATTCGCCCTTAATC -> AGGTATTCGCCCTTAATCA
CAGGTTCTACCGTGCCCTC -> AGGTTCTACCGTGCCCTCC
CAGTATTGTAGCCCGTCCT -> AGTATTGTAGCCCGTCCTA
CAGTCAGTGCGACCGTCGG -> AGTCAGTGCGACCGTCGGA
CAGTCGAGCTTTCTAGCAC -> AGTCGAGCTTTCTAGCACG
CAGTGCGACCGTCGGATCT -> AGTGCGACCGTCGGATCTA
CAGTGGCCAAGCGGGGGGC -> AGTGGCCAAGCGGGGGGCT
CAGTTGATAGTCTTTCAAC -> AGTTGATAGTCTTTCAACG
CAGTTGGACCTCCCACGTG -> AGTTGGACCTCCCACGTGC
CAGTTGTCAACTCCCTGTT -> AGTTGTCAACTCCCTGTTC
CAGTTTTGTTCATGGGACA -> AGTTTTGTTCATGGGACAT,AGTTTTGTTCATGGGACAA,AGTTTTGTTCATGGGACAC,AGTTTTGTTCATGGGACAG
CATAACCAGCAAGGGCCCA -> ATAACCAGCAAGGGCCCAA
CATAAGGCGCGTGGGCAAA -> ATAAGGCGCGTGGGCAAAG
CATAAGGCGTTACGGATTA -> ATAAGGCGTTACGGATTAA
CATACCGTGAGGTCAGTAT -> ATACCGTGAGGTCAGTATT
CATACGGGATTGATAATAG -> ATACGGGATTGATAATAGG
CATACTGCTACCGATGAAG -> ATACTGCTACCGATGAAGT
CATAGCCAACTTAACGTTA -> ATAGCCAACTTAACGTTAT
CATAGCTGGCGCGAGCGGG -> ATAGCTGGCGCGAGCGGGA
CATAGTCCACGAGCAAAAC -> ATAGTCCACGAGCAAAACA
CATATAGATCGTAGACACA -> ATATAGATCGTAGACACAT
CATATTCTGGGTCACTACA -> ATATTCTGGGTCACTACAG
CATCAAACGCCCGCCGTTT -> ATCAAACGCCCGCCGTTTC
CATCAAGATGTCCCAGGCA -> ATCAAGATGTCCCAGGCAG
CATCCATCCCTGTCGTATG -> ATCCATCCCTGTCGTATGC
CATCCCTGTCGTATGCCAT -> ATCCCTGTCGTATGCCATC
CATCCTTCTGATAGCTAGG -> ATCCTTCTGATAGCTAGGG
CATCGCCCCATTGAATACG -> ATCGCCCCATTGAATACGC
CATCGGGGCAGAAAATGAC -> ATCGGGGCAGAAAATGACT
CATCTCAAGGTCTCATAGC -> ATCTCAAGGTCTCATAGCC
CATCTGCTTACTGTGATGT -> ATCTGCTTACTGTGATGTG
CATCTGGCCCCGATACCGT -> ATCTGGCCCCGATACCGTG
CATGAAATTTCGCAAACGA -> ATGAAATTTCGCAAACGAA
CATGAGGTAAATTCCTAAG -> ATGAGGTAAATTCCTAAGA
CATGATTGGTAAGCGTCAT -> ATGATTGGTAAGCGTCATC
CATGCACTCATAGCTGGCG -> ATGCACTCATAGCTGGCGC
CATGCAGATGGGCAGAAAA -> ATGCAGATGGGCAGAAAAT
CATGCGACAAGCACAGCCT -> ATGCGACAAGCACAGCCTT
CATGGAAAGCATGCGACAA -> ATGGAAAGCATGCGACAAG
CATGGCGCTCCATCGGGGC -> ATGGCGCTCCATCGGGGCA
CATGGGACAACAATTTGAT -> ATGGGACAACAATTTGATT
CATGGGACACTACACAAAC -> ATGGGACACTACACAAACG
CATGGGACAGTTGATAGTC -> ATGGGACAGTTGATAGTCT
CATGGGACATATAGATCGT -> ATGGGACATATAGATCGTA
CATGGGGAACTGTGCCGTG -> ATGGGGAACTGTGCCGTGC
CATTAGCCCCGTCAAGGAA -> ATTAGCCCCGTCAAGGAAG
CATTGAATACGCTCAGAGT -> ATTGAATACGCTCAGAGTT
CATTGCCTTTGTCTCCTGT -> ATTGCCTTTGTCTCCTGTA
CCAAAACGGAGGCGGCCCT -> CAAAACGGAGGCGGCCCTC
CCAACATCCATCCCTGTCG -> CAACATCCATCCCTGTCGT
CCAACTCGCCGATTTGCTC -> CAACTCGCCGATTTGCTCT
CCAACTTAACGTTATCAAG -> CAACTTAACGTTATCAAGA
CCAAGAGACAGGAATCTTT -> CAAGAGACAGGAATCTTTG
CCAAGCGGGGGGCTTGAAT -> CAAGCGGGGGGCTTGAATG
CCAAGGCGGCCAACATCCA -> CAAGGCGGCCAACATCCAT
CCAATCGCCGCGTTTCAAG -> CAATCGCCGCGTTTCAAGG
CCAATGAGTGTTTTTGAAG -> CAATGAGTGTTTTTGAAGG
CCAATTGTGTCCTATTGTG -> CAATTGTGTCCTATTGTGT
CCACATAAGGCGCGTGGGC -> CACATAAGGCGCGTGGGCA
CCACATCAAACGCCCGCCG -> CACATCAAACGCCCGCCGT
CCACGAGCAAAACACGCCC -> CACGAGCAAAACACGCCCG
CCACGGCAGTCAGTGCGAC -> CACGGCAGTCAGTGCGACC
CCACGTGCCGTAAGCCCGC -> CACGTGCCGTAAGCCCGCA
CCACTATCGCGGATCCAGC -> CACTATCGCGGATCCAGCT
CCACTGAACGGGATCCAAT -> CACTGAACGGGATCCAATG
CCACTGGTACCTATACTCC -> CACTGGTACCTATACTCCC
CCAGCAAGGGCCCAATCGC -> CAGCAAGGGCCCAATCGCC
CCAGCTCCCTTGGACACTT -> CAGCTCCCTTGGACACTTT
CCAGGCAGAGGGTTATGCG -> CAGGCAGAGGGTTATGCGG
CCAGGCCTGGGCAAGATAC -> CAGGCCTGGGCAAGATACG
CCAGGCGACACCGCAGATT -> CAGGCGACACCGCAGATTC
CCAGGTACAATCCTTACGA -> CAGGTACAATCCTTACGAC
CCAGTTGGACCTCCCACGT -> CAGTTGGACCTCCCACGTG
CCAGTTTTGTTCATGGGAC -> CAGTTTTGTTCATGGGACA
CCATAACCAGCAAGGGCCC -> CATAACCAGCAAGGGCCCA
CCATAAGGCGTTACGGATT -> CATAAGGCGTTACGGATTA
CCATATTCTGGGTCACTAC -> CATATTCTGGGTCACTACA
CCATCCCTGTCGTATGCCA -> CATCCCTGTCGTATGCCAT
CCATCCTTCTGATAGCTAG -> CATCCTTCTGATAGCTAGG
CCATCGGGGCAGAAAATGA -> CATCGGGGCAGAAAATGAC
CCATTGAATACGCTCAGAG -> CATTGAATACGCTCAGAGT
CCCAATCGCCGCGTTTCAA -> CCAATCGCCGCGTTTCAAG
CCCACGTGCCGTAAGCCCG -> CCACGTGCCGTAAGCCCGC
CCCACTGGTACCTATACTC -> CCACTGGTACCTATACTCC
CCCAGGCAGAGGGTTATGC -> CCAGGCAGAGGGTTATGCG
CCCAGGTACAATCCTTACG -> CCAGGTACAATCCTTACGA
CCCATATTCTGGGTCACTA -> CCATATTCTGGGTCACTAC
CCCATTGAATACGCTCAGA -> CCATTGAATACGCTCAGAG
CCCCATTGAATACGCTCAG -> CCCATTGAATACGCTCAGA
CCCCCGAGCGTGGAGCGTG -> CCCCGAGCGTGGAGCGTGC
CCCCCTTTCAGTTTTGTTC -> CCCCTTTCAGTTTTGTTCA
CCCCGAGCGTGGAGCGTGC -> CCCGAGCGTGGAGCGTGCC
CCCCGATACCGTGGCTGCC -> CCCGATACCGTGGCTGCCC
CCCCGTCAAGGAAGTCTGA -> CCCGTCAAGGAAGTCTGAG
CCCCTACAAGTCTATAAAC -> CCCTACAAGTCTATAAACC
CCCCTTTCAGTTTTGTTCA -> CCCTTTCAGTTTTGTTCAT
CCCGAGCGGATATGTTCTG -> CCGAGCGGATATGTTCTGA
CCCGAGCGTGGAGCGTGCC -> CCGAGCGTGGAGCGTGCCC
CCCGATACCGTGGCTGCCC -> CCGATACCGTGGCTGCCCT
CCCGCAGGTAGAATCTATA -> CCGCAGGTAGAATCTATAT
CCCGCCGTTTCAATGTAAG -> CCGCCGTTTCAATGTAAGG
CCCGTCAAGGAAGTCTGAG -> CCGTCAAGGAAGTCTGAGA
CCCGTCCTATGACATGGGG -> CCGTCCTATGACATGGGGA
CCCGTGACCCCCGAGCGTG -> CCGTGACCCCCGAGCGTGG
CCCTACAAGTCTATAAACC -> CCTACAAGTCTATAAACCA
CCCTACCTCGTACCGATGC -> CCTACCTCGTACCGATGCG
CCCTCCAAGGCGGCCAACA -> CCTCCAAGGCGGCCAACAT
CCCTCTGGAGGGACCTCCA -> CCTCTGGAGGGACCTCCAA
CCCTGACATGCAGATGGGC -> CCTGACATGCAGATGGGCA
CCCTGGAGGGTGATTAACC -> CCTGGAGGGTGATTAACCA
CCCTGTCGTATGCCATCCT -> CCTGTCGTATGCCATCCTT
CCCTGTTCAAATTTACTGG -> CCTGTTCAAATTTACTGGA
CCCTTAATCAAGGGCCGTG -> CCTTAATCAAGGGCCGTGC
CCCTTAATTGACGCGGTAA -> CCTTAATTGACGCGGTAAC
CCCTTGGACACTTTGAACC -> CCTTGGACACTTTGAACCC
CCCTTTCAGTTTTGTTCAT -> CCTTTCAGTTTTGTTCATG
CCCTTTGGTCATACCGTGA -> CCTTTGGTCATACCGTGAG
CCGAGCGGATATGTTCTGA -> CGAGCGGATATGTTCTGAG
CCGAGCGTGGAGCGTGCCC -> CGAGCGTGGAGCGTGCCCA
CCGATACCGTGGCTGCCCT -> CGATACCGTGGCTGCCCTT
CCGATGAAGTAGCGCCAGT -> CGATGAAGTAGCGCCAGTT
CCGATGCGGCTAGGGTTGG -> CGATGCGGCTAGGGTTGGC
CCGATTTGCTCTGGAGGTG -> CGATTTGCTCTGGAGGTGC
CCGCAGATTCTTGGTCGGA -> CGCAGATTCTTGGTCGGAC
CCGCAGGTAGAATCTATAT -> CGCAGGTAGAATCTATATT
CCGCCGTTTCAATGTAAGG -> CGCCGTTTCAATGTAAGGG
CCGCGAATGATACGCCGTA -> CGCGAATGATACGCCGTAT
CCGCGTTTCAAGGCGAGAT -> CGCGTTTCAAGGCGAGATC
CCGGGTAGTGGTCGCATGG -> CGGGTAGTGGTCGCATGGC
CCGGTGAATAGCGGGGGAT -> CGGTGAATAGCGGGGGATA
CCGTAAGCCCGCAGGTAGA -> CGTAAGCCCGCAGGTAGAA
CCGTATTGACACATCTCAA -> CGTATTGACACATCTCAAG
CCGTCAAGGAAGTCTGAGA -> CGTCAAGGAAGTCTGAGAT
CCGTCAGCAGGTTCTACCG -> CGTCAGCAGGTTCTACCGT
CCGTCCTATGACATGGGGA -> CGTCCTATGACATGGGGAA
CCGTCGGATCTAAAGTGGC -> CGTCGGATCTAAAGTGGCA
CCGTGACCCCCGAGCGTGG -> CGTGACCCCCGAGCGTGGA
CCGTGAGGTCAGTATTGTA -> CGTGAGGTCAGTATTGTAG
CCGTGCATGGAAAGCATGC -> CGTGCATGGAAAGCATGCG
CCGTGCCCTCCAAGGCGGC -> CGTGCCCTCCAAGGCGGCC
CCGTGCCTGGGAGGGGCTC -> CGTGCCTGGGAGGGGCTCT
CCGTGGCTGCCCTTAATTG -> CGTGGCTGCCCTTAATTGA
CCGTGTTATCCACTATCGC -> CGTGTTATCCACTATCGCG
CCGTTTCAATGTAAGGGGC -> CGTTTCAATGTAAGGGGCT
CCTAACGCTTTTCGGTGCA -> CTAACGCTTTTCGGTGCAG
CCTAAGAACAAAACCTAGG -> CTAAGAACAAAACCTAGGT
CCTAATGTCGAATTATTAT -> CTAATGTCGAATTATTATC
CCTACAAGTCTATAAACCA -> CTACAAGTCTATAAACCAA
CCTACCTCGTACCGATGCG -> CTACCTCGTACCGATGCGG
CCTAGGTACGTTATACAGG -> CTAGGTACGTTATACAGGA
CCTATACTCCCGTGACCCC -> CTATACTCCCGTGACCCCC
CCTATGACATGGGGAACTG -> CTATGACATGGGGAACTGT
CCTATTGCGGTAATAAACT -> CTATTGCGGTAATAAACTC
CCTATTGTGTTGGAATCTC -> CTATTGTGTTGGAATCTCG
CCTCAGCGGGCAGAAAATG -> CTCAGCGGGCAGAAAATGA
CCTCCAAGAGACAGGAATC -> CTCCAAGAGACAGGAATCT
CCTCCAAGGCGGCCAACAT -> CTCCAAGGCGGCCAACATC
CCTCCCACGTGCCGTAAGC -> CTCCCACGTGCCGTAAGCC
CCTCCGCGAATGATACGCC -> CTCCGCGAATGATACGCCG
CCTCCTCCGCGAATGATAC -> CTCCTCCGCGAATGATACG
CCTCGTACCGATGCGGCTA -> CTCGTACCGATGCGGCTAG
CCTCTAATGGTCTACGGGA -> CTCTAATGGTCTACGGGAC
CCTCTGGAGGGACCTCCAA -> CTCTGGAGGGACCTCCAAG
CCTGACATGCAGATGGGCA -> CTGACATGCAGATGGGCAG
CCTGACGTATTAACAGCAC -> CTGACGTATTAACAGCACC
CCTGGAGGGTGATTAACCA -> CTGGAGGGTGATTAACCAT
CCTGGATAATCAGAGAGTG -> CTGGATAATCAGAGAGTGA
CCTGGGAGGGGCTCTCACG -> CTGGGAGGGGCTCTCACGT
CCTGGGCAAGATACGAAAG -> CTGGGCAAGATACGAAAGT
CCTGTATCGTCAGCCAATT -> CTGTATCGTCAGCCAATTG
CCTGTCGTATGCCATCCTT -> CTGTCGTATGCCATCCTTC
CCTGTTCAAATTTACTGGA -> CTGTTCAAATTTACTGGAA
CCTTAATCAAGGGCCGTGC -> CTTAATCAAGGGCCGTGCA
CCTTAATTGACGCGGTAAC -> CTTAATTGACGCGGTAACC
CCTTACGACATGAAATTTC -> CTTACGACATGAAATTTCG
CCTTCTGATAGCTAGGGCT -> CTTCTGATAGCTAGGGCTA
CCTTCTGTGTGAATGTTAT -> CTTCTGTGTGAATGTTATA
CCTTGCGTCTCTAAACTCG -> CTTGCGTCTCTAAACTCGG
CCTTGGACACTTTGAACCC -> CTTGGACACTTTGAACCCT
CCTTTCAGTTTTGTTCATG -> CTTTCAGTTTTGTTCATGG
CCTTTGGTCATACCGTGAG -> CTTTGGTCATACCGTGAGG
CCTTTGTCTCCTGTATCGT -> CTTTGTCTCCTGTATCGTC
CGAAAGACCACTGAACGGG -> GAAAGACCACTGAACGGGA
CGAAAGTTGGCACAGAAAA -> GAAAGTTGGCACAGAAAAA
CGAATGATACGCCGTATTG -> GAATGATACGCCGTATTGA
CGAATGTCCCTACCTCGTA -> GAATGTCCCTACCTCGTAC
CGAATTATTATCTCCAACT -> GAATTATTATCTCCAACTC
CGACAAGCACAGCCTTGCG -> GACAAGCACAGCCTTGCGT
CGACACCGCAGATTCTTGG -> GACACCGCAGATTCTTGGT
CGACATGAAATTTCGCAAA -> GACATGAAATTTCGCAAAC
CGACCGTCGGATCTAAAGT -> GACCGTCGGATCTAAAGTG
CGACTGGCTGCCAGTTTTG -> GACTGGCTGCCAGTTTTGT
CGACTGGGCTTTTAGCATA -> GACTGGGCTTTTAGCATAG
CGAGATCAGTCGAGCTTTC -> GAGATCAGTCGAGCTTTCT
CGAGCAAAACACGCCCGAG -> GAGCAAAACACGCCCGAGC
CGAGCCTGACGTATTAACA -> GAGCCTGACGTATTAACAG
CGAGCGGATATGTTCTGAG -> GAGCGGATATGTTCTGAGC
CGAGCGGGAGTACCCACTG -> GAGCGGGAGTACCCACTGG
CGAGCGTGGAGCGTGCCCA -> GAGCGTGGAGCGTGCCCAG
CGAGCTTTCTAGCACGACT -> GAGCTTTCTAGCACGACTG
CGATACCGTGGCTGCCCTT -> GATACCGTGGCTGCCCTTA
CGATGAAGTAGCGCCAGTT -> GATGAAGTAGCGCCAGTTG
CGATGCGGCTAGGGTTGGC -> GATGCGGCTAGGGTTGGCT
CGATTTGCTCTGGAGGTGC -> GATTTGCTCTGGAGGTGCG
CGCAAAATCAATAGGGCAG -> GCAAAATCAATAGGGCAGA
CGCAAACGAATGTCCCTAC -> GCAAACGAATGTCCCTACC
CGCACACTTCGGGGGACAT -> GCACACTTCGGGGGACATC
CGCAGATTCTTGGTCGGAC -> GCAGATTCTTGGTCGGACA
CGCAGGTAGAATCTATATT -> GCAGGTAGAATCTATATTA
CGCATGGCGCTCCATCGGG -> GCATGGCGCTCCATCGGGG
CGCCAGTTGGACCTCCCAC -> GCCAGTTGGACCTCCCACG
CGCCCCATTGAATACGCTC -> GCCCCATTGAATACGCTCA
CGCCCGAGCGGATATGTTC -> GCCCGAGCGGATATGTTCT
CGCCCGCCGTTTCAATGTA -> GCCCGCCGTTTCAATGTAA
CGCCCTTAATCAAGGGCCG -> GCCCTTAATCAAGGGCCGT
CGCCGATTTGCTCTGGAGG -> GCCGATTTGCTCTGGAGGT
CGCCGCGTTTCAAGGCGAG -> GCCGCGTTTCAAGGCGAGA
CGCCGTATTGACACATCTC -> GCCGTATTGACACATCTCA
CGCCGTTTCAATGTAAGGG -> GCCGTTTCAATGTAAGGGG
CGCCTTCTGTGTGAATGTT -> GCCTTCTGTGTGAATGTTA
CGCGAATGATACGCCGTAT -> GCGAATGATACGCCGTATT
CGCGAGCGGGAGTACCCAC -> GCGAGCGGGAGTACCCACT
CGCGGATCCAGCTCCCTTG -> GCGGATCCAGCTCCCTTGG
CGCGGGTGCCTCAGCGGGC -> GCGGGTGCCTCAGCGGGCA
CGCGGTAACCACATCAAAC -> GCGGTAACCACATCAAACG
CGCGTGGGCAAAGTTGAAG -> GCGTGGGCAAAGTTGAAGT
CGCGTTTCAAGGCGAGATC -> GCGTTTCAAGGCGAGATCA
CGCTAAAGGGCTAGCTTGA -> GCTAAAGGGCTAGCTTGAA
CGCTACTAGGTTAACATAC -> GCTACTAGGTTAACATACT
CGCTCAGAGTTCAAACTGC -> GCTCAGAGTTCAAACTGCT
CGCTCCATCGGGGCAGAAA -> GCTCCATCGGGGCAGAAAA
CGCTTTTCGGTGCAGTGGC -> GCTTTTCGGTGCAGTGGCC
CGGAATTCAAATACATGAT -> GGAATTCAAATACATGATT
CGGACACGCTAAAGGGCTA -> GGACACGCTAAAGGGCTAG
CGGACCTGGATAATCAGAG -> GGACCTGGATAATCAGAGA
CGGAGGCGGCCCTCTGGAG -> GGAGGCGGCCCTCTGGAGG
CGGATATGTTCTGAGCATT -> GGATATGTTCTGAGCATTG
CGGATCCAGCTCCCTTGGA -> GGATCCAGCTCCCTTGGAC
CGGATCTAAAGTGGCAAAT -> GGATCTAAAGTGGCAAATC
CGGATCTGGGAAAATCGGA -> GGATCTGGGAAAATCGGAA
CGGATTAACACCACGGCAG -> GGATTAACACCACGGCAGT
CGGCAGTCAGTGCGACCGT -> GGCAGTCAGTGCGACCGTC
CGGCCAACATCCATCCCTG -> GGCCAACATCCATCCCTGT
CGGCCAGGCCTGGGCAAGA -> GGCCAGGCCTGGGCAAGAT
CGGCCCTCTGGAGGGACCT -> GGCCCTCTGGAGGGACCTC
CGGCTAACGTGGCGCTACT -> GGCTAACGTGGCGCTACTA
CGGCTAGGGTTGGCTGGAC -> GGCTAGGGTTGGCTGGACC
CGGGACGCCTTCTGTGTGA -> GGGACGCCTTCTGTGTGAA
CGGGAGTACCCACTGGTAC -> GGGAGTACCCACTGGTACC
CGGGATCCAATGAGTGTTT -> GGGATCCAATGAGTGTTTT
CGGGATTGATAATAGGATA -> GGGATTGATAATAGGATAT
CGGGCAGAAAATGACTGGA -> GGGCAGAAAATGACTGGAC
CGGGGCAGAAAATGACTGG -> GGGGCAGAAAATGACTGGA
CGGGGGACATCAAGATGTC -> GGGGGACATCAAGATGTCC
CGGGGGATATCGGTGGGGC -> GGGGGATATCGGTGGGGCA
CGGGGGGCTTGAATGTGGG -> GGGGGGCTTGAATGTGGGT
CGGGTAAATCACGCAAAAT -> GGGTAAATCACGCAAAATC
CGGGTACCTCTAATGGTCT -> GGGTACCTCTAATGGTCTA
CGGGTAGTGGTCGCATGGC -> GGGTAGTGGTCGCATGGCG
CGGGTGCCTCAGCGGGCAG -> GGGTGCCTCAGCGGGCAGA
CGGTAACCACATCAAACGC -> GGTAACCACATCAAACGCC
CGGTAATAAACTCGGGTAC -> GGTAATAAACTCGGGTACC
CGGTCCAGGCGACACCGCA -> GGTCCAGGCGACACCGCAG
CGGTGAATAGCGGGGGATA -> GGTGAATAGCGGGGGATAT
CGGTGCAGTGGCCAAGCGG -> GGTGCAGTGGCCAAGCGGG
CGGTGGGGCATCTGCTTAC -> GGTGGGGCATCTGCTTACT
CGTAAGCCCGCAGGTAGAA -> GTAAGCCCGCAGGTAGAAT
CGTACCGATGCGGCTAGGG -> GTACCGATGCGGCTAGGGT
CGTAGAATCCTATTGCGGT -> GTAGAATCCTATTGCGGTA
CGTAGACACATGCACTCAT -> GTAGACACATGCACTCATA
CGTATACACATGAGGTAAA -> GTATACACATGAGGTAAAT
CGTATGCCATCCTTCTGAT -> GTATGCCATCCTTCTGATA
CGTATTAACAGCACCGGTG -> GTATTAACAGCACCGGTGA
CGTATTGACACATCTCAAG -> GTATTGACACATCTCAAGG
CGTCAAGGAAGTCTGAGAT -> GTCAAGGAAGTCTGAGATT
CGTCAATCTGGACGAGCCT -> GTCAATCTGGACGAGCCTG
CGTCAGCAACGTATACACA -> GTCAGCAACGTATACACAT
CGTCAGCAGGTTCTACCGT -> GTCAGCAGGTTCTACCGTG
CGTCAGCCAATTGTGTCCT -> GTCAGCCAATTGTGTCCTA
CGTCATCGCCCCATTGAAT -> GTCATCGCCCCATTGAATA
CGTCCTATGACATGGGGAA -> GTCCTATGACATGGGGAAC
CGTCGGATCTAAAGTGGCA -> GTCGGATCTAAAGTGGCAA
CGTCTCTAAACTCGGGTAA -> GTCTCTAAACTCGGGTAAA
CGTGACCCCCGAGCGTGGA -> GTGACCCCCGAGCGTGGAG
CGTGAGGTCAGTATTGTAG -> GTGAGGTCAGTATTGTAGC
CGTGCATGGAAAGCATGCG -> GTGCATGGAAAGCATGCGA
CGTGCCCAGGTACAATCCT -> GTGCCCAGGTACAATCCTT
CGTGCCCTCCAAGGCGGCC -> GTGCCCTCCAAGGCGGCCA
CGTGCCGTAAGCCCGCAGG -> GTGCCGTAAGCCCGCAGGT
CGTGCCTGGGAGGGGCTCT -> GTGCCTGGGAGGGGCTCTC
CGTGGAGCGTGCCCAGGTA -> GTGGAGCGTGCCCAGGTAC
CGTGGCGCTACTAGGTTAA -> GTGGCGCTACTAGGTTAAC
CGTGGCTGCCCTTAATTGA -> GTGGCTGCCCTTAATTGAC
CGTGGGCAAAGTTGAAGTT -> GTGGGCAAAGTTGAAGTTC
CGTGTTATCCACTATCGCG -> GTGTTATCCACTATCGCGG
CGTTACGGATTAACACCAC -> GTTACGGATTAACACCACG
CGTTATACAGGACGCACAC -> GTTATACAGGACGCACACT
CGTTATCAAGAGAATCACA -> GTTATCAAGAGAATCACAG
CGTTGAGCCCCTACAAGTC -> GTTGAGCCCCTACAAGTCT
CGTTTCAAGGCGAGATCAG -> GTTTCAAGGCGAGATCAGT
CGTTTCAATGTAAGGGGCT -> GTTTCAATGTAAGGGGCTA
CTAAACTCGGGTAAATCAC -> TAAACTCGGGTAAATCACG
CTAAAGGGCTAGCTTGAAA -> TAAAGGGCTAGCTTGAAAC
CTAAAGTGGCAAATCATTA -> TAAAGTGGCAAATCATTAG
CTAACGCTTTTCGGTGCAG -> TAACGCTTTTCGGTGCAGT
CTAACGTGGCGCTACTAGG -> TAACGTGGCGCTACTAGGT
CTAAGAACAAAACCTAGGT -> TAAGAACAAAACCTAGGTA
CTAATGGTCTACGGGACGC -> TAATGGTCTACGGGACGCC
CTAATGTCGAATTATTATC -> TAATGTCGAATTATTATCT
CTACAAGTCTATAAACCAA -> TACAAGTCTATAAACCAAA
CTACACAAACGGCCAGGCC -> TACACAAACGGCCAGGCCT
CTACAGTTGTCAACTCCCT -> TACAGTTGTCAACTCCCTG
CTACCCTGGAGGGTGATTA -> TACCCTGGAGGGTGATTAA
CTACCGATGAAGTAGCGCC -> TACCGATGAAGTAGCGCCA
CTACCGTGCCCTCCAAGGC -> TACCGTGCCCTCCAAGGCG
CTACCTCGTACCGATGCGG -> TACCTCGTACCGATGCGGC
CTACGGGACGCCTTCTGTG -> TACGGGACGCCTTCTGTGT
CTACTAGGTTAACATACTG -> TACTAGGTTAACATACTGC
CTAGCACGACTGGGCTTTT -> TAGCACGACTGGGCTTTTA
CTAGCTTGAAACTTAGTGT -> TAGCTTGAAACTTAGTGTA
CTAGGGCTACCCTGGAGGG -> TAGGGCTACCCTGGAGGGT
CTAGGGCTCGGACCTGGAT -> TAGGGCTCGGACCTGGATA
CTAGGGTTGGCTGGACCAT -> TAGGGTTGGCTGGACCATA
CTAGGTACGTTATACAGGA -> TAGGTACGTTATACAGGAC
CTAGGTTAACATACTGCTA -> TAGGTTAACATACTGCTAC
CTATAAACCAAAACGGAGG -> TATAAACCAAAACGGAGGC
CTATACTCCCGTGACCCCC -> TATACTCCCGTGACCCCCG
CTATATTATGGGGCCCATA -> TATATTATGGGGCCCATAT
CTATCGCGGATCCAGCTCC -> TATCGCGGATCCAGCTCCC
CTATGACATGGGGAACTGT -> TATGACATGGGGAACTGTG
CTATTGCGGTAATAAACTC -> TATTGCGGTAATAAACTCG
CTATTGTGTTGGAATCTCG -> TATTGTGTTGGAATCTCGC
CTCAAGGTCTCATAGCCAA -> TCAAGGTCTCATAGCCAAC
CTCACGTCAGCAACGTATA -> TCACGTCAGCAACGTATAC
CTCAGAGTTCAAACTGCTG -> TCAGAGTTCAAACTGCTGG
CTCAGCGGGCAGAAAATGA -> TCAGCGGGCAGAAAATGAC
CTCATAGCCAACTTAACGT -> TCATAGCCAACTTAACGTT
CTCATAGCTGGCGCGAGCG -> TCATAGCTGGCGCGAGCGG
CTCCAACTCGCCGATTTGC -> TCCAACTCGCCGATTTGCT
CTCCAAGAGACAGGAATCT -> TCCAAGAGACAGGAATCTT
CTCCAAGGCGGCCAACATC -> TCCAAGGCGGCCAACATCC
CTCCATCGGGGCAGAAAAT -> TCCATCGGGGCAGAAAATG
CTCCCACGTGCCGTAAGCC -> TCCCACGTGCCGTAAGCCC
CTCCCGTGACCCCCGAGCG -> TCCCGTGACCCCCGAGCGT
CTCCCTGTTCAAATTTACT -> TCCCTGTTCAAATTTACTG
CTCCCTTGGACACTTTGAA -> TCCCTTGGACACTTTGAAC
CTCCGCGAATGATACGCCG -> TCCGCGAATGATACGCCGT
CTCCTCCGCGAATGATACG -> TCCTCCGCGAATGATACGC
CTCCTGTATCGTCAGCCAA -> TCCTGTATCGTCAGCCAAT
CTCGCCGATTTGCTCTGGA -> TCGCCGATTTGCTCTGGAG
CTCGCGGGTGCCTCAGCGG -> TCGCGGGTGCCTCAGCGGG
CTCGGACCTGGATAATCAG -> TCGGACCTGGATAATCAGA
CTCGGATCTGGGAAAATCG -> TCGGATCTGGGAAAATCGG
CTCGGGTAAATCACGCAAA -> TCGGGTAAATCACGCAAAA
CTCGGGTACCTCTAATGGT -> TCGGGTACCTCTAATGGTC
CTCGGTCCAGGCGACACCG -> TCGGTCCAGGCGACACCGC
CTCGTACCGATGCGGCTAG -> TCGTACCGATGCGGCTAGG
CTCTAAACTCGGGTAAATC -> TCTAAACTCGGGTAAATCA
CTCTAATGGTCTACGGGAC -> TCTAATGGTCTACGGGACG
CTCTCACGTCAGCAACGTA -> TCTCACGTCAGCAACGTAT
CTCTGGAGGGACCTCCAAG -> TCTGGAGGGACCTCCAAGA
CTCTGGAGGTGCGTCAATC -> TCTGGAGGTGCGTCAATCT
CTGAACGGGATCCAATGAG -> TGAACGGGATCCAATGAGT
CTGACATGCAGATGGGCAG -> TGACATGCAGATGGGCAGA
CTGACGTATTAACAGCACC -> TGACGTATTAACAGCACCG
CTGAGATTGGGCACCACAT -> TGAGATTGGGCACCACATA
CTGAGCATTGCCTTTGTCT -> TGAGCATTGCCTTTGTCTC
CTGATAGCTAGGGCTACCC -> TGATAGCTAGGGCTACCCT
CTGCAGTTTTGTTCATGGG -> TGCAGTTTTGTTCATGGGA
CTGCCAGTTTTGTTCATGG -> TGCCAGTTTTGTTCATGGG
CTGCCCTTAATTGACGCGG -> TGCCCTTAATTGACGCGGT
CTGCGAAAGACCACTGAAC -> TGCGAAAGACCACTGAACG
CTGCTACCGATGAAGTAGC -> TGCTACCGATGAAGTAGCG
CTGCTGGCATACGGGATTG -> TGCTGGCATACGGGATTGA
CTGCTTACTGTGATGTGTC -> TGCTTACTGTGATGTGTCA
CTGGAAAGCCTCCTCCGCG -> TGGAAAGCCTCCTCCGCGA
CTGGAAGTATTGGCTGCAG -> TGGAAGTATTGGCTGCAGT
CTGGACCATAAGGCGTTAC -> TGGACCATAAGGCGTTACG
CTGGACGACTGGCTGCCAG -> TGGACGACTGGCTGCCAGT
CTGGACGAGCCTGACGTAT -> TGGACGAGCCTGACGTATT
CTGGAGGGACCTCCAAGAG -> TGGAGGGACCTCCAAGAGA
CTGGAGGGTGATTAACCAT -> TGGAGGGTGATTAACCATA
CTGGAGGTGCGTCAATCTG -> TGGAGGTGCGTCAATCTGG
CTGGAGTGCCCCCTTTCAG -> TGGAGTGCCCCCTTTCAGT
CTGGATAATCAGAGAGTGA -> TGGATAATCAGAGAGTGAA
CTGGATGATGGGAGAACAG -> TGGATGATGGGAGAACAGT
CTGGCATACGGGATTGATA -> TGGCATACGGGATTGATAA
CTGGCCCCGATACCGTGGC -> TGGCCCCGATACCGTGGCT
CTGGCGCGAGCGGGAGTAC -> TGGCGCGAGCGGGAGTACC
CTGGCTGCCAGTTTTGTTC -> TGGCTGCCAGTTTTGTTCA
CTGGGAAAATCGGAATTCA -> TGGGAAAATCGGAATTCAA
CTGGGAGGGGCTCTCACGT -> TGGGAGGGGCTCTCACGTC
CTGGGCAAGATACGAAAGT -> TGGGCAAGATACGAAAGTT
CTGGGCTTTTAGCATAGTC -> TGGGCTTTTAGCATAGTCC
CTGGGTCACTACAGTTGTC -> TGGGTCACTACAGTTGTCA
CTGGTACCTATACTCCCGT -> TGGTACCTATACTCCCGTG
CTGTATCGTCAGCCAATTG -> TGTATCGTCAGCCAATTGT
CTGTCGTATGCCATCCTTC -> TGTCGTATGCCATCCTTCT
CTGTGATGTGTCAGATGCA -> TGTGATGTGTCAGATGCAA
CTGTGCCGTGCCTGGGAGG -> TGTGCCGTGCCTGGGAGGG
CTGTGTGAATGTTATATCC -> TGTGTGAATGTTATATCCT
CTGTTCAAATTTACTGGAA -> TGTTCAAATTTACTGGAAA
CTTAACGTTATCAAGAGAA -> TTAACGTTATCAAGAGAAT
CTTAATCAAGGGCCGTGCA -> TTAATCAAGGGCCGTGCAT
CTTAATTGACGCGGTAACC -> TTAATTGACGCGGTAACCA
CTTACGACATGAAATTTCG -> TTACGACATGAAATTTCGC
CTTACTGTGATGTGTCAGA -> TTACTGTGATGTGTCAGAT
CTTAGTGTAGTAGGTCTCG -> TTAGTGTAGTAGGTCTCGG
CTTCGGGGGACATCAAGAT -> TTCGGGGGACATCAAGATG
CTTCTGATAGCTAGGGCTA -> TTCTGATAGCTAGGGCTAC
CTTCTGTGTGAATGTTATA -> TTCTGTGTGAATGTTATAT
CTTGAAACTTAGTGTAGTA -> TTGAAACTTAGTGTAGTAG
CTTGAATGTGGGTGTTCAA -> TTGAATGTGGGTGTTCAAA
CTTGCGTCTCTAAACTCGG -> TTGCGTCTCTAAACTCGGG
CTTGGACACTTTGAACCCT -> TTGGACACTTTGAACCCTG
CTTGGTCGGACACGCTAAA -> TTGGTCGGACACGCTAAAG
CTTTCAACGTAGAATCCTA -> TTTCAACGTAGAATCCTAT
CTTTCAGTTTTGTTCATGG -> TTTCAGTTTTGTTCATGGG
CTTTCTAGCACGACTGGGC -> TTTCTAGCACGACTGGGCT
CTTTGAACCCTGACATGCA -> TTTGAACCCTGACATGCAG
CTTTGGTCATACCGTGAGG -> TTTGGTCATACCGTGAGGT
CTTTGTCTCCTGTATCGTC -> TTTGTCTCCTGTATCGTCA
CTTTGTGGGCTATTATCGT -> TTTGTGGGCTATTATCGTC
CTTTTAGCATAGTCCACGA -> TTTTAGCATAGTCCACGAG
CTTTTCGGTGCAGTGGCCA -> TTTTCGGTGCAGTGGCCAA
GAAAAACTGCGAAAGACCA -> AAAAACTGCGAAAGACCAC
GAAAACTCGGTCCAGGCGA -> AAAACTCGGTCCAGGCGAC
GAAAATCGGAATTCAAATA -> AAAATCGGAATTCAAATAC
GAAAATGACTGGAAGTATT -> AAAATGACTGGAAGTATTG
GAAAATGACTGGACGACTG -> AAAATGACTGGACGACTGG
GAAAATGACTGGAGTGCCC -> AAAATGACTGGAGTGCCCC
GAAAATGACTGGATGATGG -> AAAATGACTGGATGATGGG
GAAACAATGGAAAACTCGG -> AAACAATGGAAAACTCGGT
GAAACTTAGTGTAGTAGGT -> AAACTTAGTGTAGTAGGTC
GAAAGACCACTGAACGGGA -> AAAGACCACTGAACGGGAT
GAAAGCATGCGACAAGCAC -> AAAGCATGCGACAAGCACA
GAAAGCCTCCTCCGCGAAT -> AAAGCCTCCTCCGCGAATG
GAAAGTTGGCACAGAAAAA -> AAAGTTGGCACAGAAAAAC
GAAATGTATCCTAACGCTT -> AAATGTATCCTAACGCTTT
GAAATTTCGCAAACGAATG -> AAATTTCGCAAACGAATGT
GAACAAAACCTAGGTACGT -> AACAAAACCTAGGTACGTT
GAACAGTTTTGTTCATGGG -> AACAGTTTTGTTCATGGGA
GAACCCTGACATGCAGATG -> AACCCTGACATGCAGATGG
GAACGGGATCCAATGAGTG -> AACGGGATCCAATGAGTGT
GAACTGTGCCGTGCCTGGG -> AACTGTGCCGTGCCTGGGA
GAAGGACGTTGAGCCCCTA -> AAGGACGTTGAGCCCCTAC
GAAGTAGCGCCAGTTGGAC -> AAGTAGCGCCAGTTGGACC
GAAGTATTGGCTGCAGTTT -> AAGTATTGGCTGCAGTTTT
GAAGTCTGAGATTGGGCAC -> AAGTCTGAGATTGGGCACC
GAAGTTCCGTGTTATCCAC -> AAGTTCCGTGTTATCCACT
GAATACGCTCAGAGTTCAA -> AATACGCTCAGAGTTCAAA
GAATAGCGGGGGATATCGG -> AATAGCGGGGGATATCGGT
GAATCACAGCCGGGTAGTG -> AATCACAGCCGGGTAGTGG
GAATCCTATTGCGGTAATA -> AATCCTATTGCGGTAATAA
GAATCTATATTATGGGGCC -> AATCTATATTATGGGGCCC
GAATCTCGCGGGTGCCTCA -> AATCTCGCGGGTGCCTCAG
GAATCTTTGTGGGCTATTA -> AATCTTTGTGGGCTATTAT
GAATGATACGCCGTATTGA -> AATGATACGCCGTATTGAC
GAATGTCCCTACCTCGTAC -> AATGTCCCTACCTCGTACC
GAATGTGGGTGTTCAAAAA -> AATGTGGGTGTTCAAAAAG
GAATGTTATATCCTAATGT -> AATGTTATATCCTAATGTC
GAATTATTATCTCCAACTC -> AATTATTATCTCCAACTCG
GAATTCAAATACATGATTG -> AATTCAAATACATGATTGG
GACAACAATTTGATTTAGA -> ACAACAATTTGATTTAGAG
GACAAGCACAGCCTTGCGT -> ACAAGCACAGCCTTGCGTC
GACACATCTCAAGGTCTCA -> ACACATCTCAAGGTCTCAT
GACACATGCACTCATAGCT -> ACACATGCACTCATAGCTG
GACACCGCAGATTCTTGGT -> ACACCGCAGATTCTTGGTC
GACACGCTAAAGGGCTAGC -> ACACGCTAAAGGGCTAGCT
GACACTACACAAACGGCCA -> ACACTACACAAACGGCCAG
GACACTTTGAACCCTGACA -> ACACTTTGAACCCTGACAT
GACAGGAATCTTTGTGGGC -> ACAGGAATCTTTGTGGGCT
GACAGTTGATAGTCTTTCA -> ACAGTTGATAGTCTTTCAA
GACATATAGATCGTAGACA -> ACATATAGATCGTAGACAC
GACATCAAGATGTCCCAGG -> ACATCAAGATGTCCCAGGC
GACATGAAATTTCGCAAAC -> ACATGAAATTTCGCAAACG
GACATGCAGATGGGCAGAA -> ACATGCAGATGGGCAGAAA
GACATGGGGAACTGTGCCG -> ACATGGGGAACTGTGCCGT
GACCACTGAACGGGATCCA -> ACCACTGAACGGGATCCAA
GACCATAAGGCGTTACGGA -> ACCATAAGGCGTTACGGAT
GACCCCCGAGCGTGGAGCG -> ACCCCCGAGCGTGGAGCGT
GACCGTCGGATCTAAAGTG -> ACCGTCGGATCTAAAGTGG
GACCTCCAAGAGACAGGAA -> ACCTCCAAGAGACAGGAAT
GACCTCCCACGTGCCGTAA -> ACCTCCCACGTGCCGTAAG
GACCTGGATAATCAGAGAG -> ACCTGGATAATCAGAGAGT
GACGACTGGCTGCCAGTTT -> ACGACTGGCTGCCAGTTTT
GACGAGCCTGACGTATTAA -> ACGAGCCTGACGTATTAAC
GACGCACACTTCGGGGGAC -> ACGCACACTTCGGGGGACA
GACGCCTTCTGTGTGAATG -> ACGCCTTCTGTGTGAATGT
GACGCGGTAACCACATCAA -> ACGCGGTAACCACATCAAA
GACGTATTAACAGCACCGG -> ACGTATTAACAGCACCGGT
GACGTTGAGCCCCTACAAG -> ACGTTGAGCCCCTACAAGT
GACTGGAAGTATTGGCTGC -> ACTGGAAGTATTGGCTGCA
GACTGGACGACTGGCTGCC -> ACTGGACGACTGGCTGCCA
GACTGGAGTGCCCCCTTTC -> ACTGGAGTGCCCCCTTTCA
GACTGGATGATGGGAGAAC -> ACTGGATGATGGGAGAACA
GACTGGCTGCCAGTTTTGT -> ACTGGCTGCCAGTTTTGTT
GACTGGGCTTTTAGCATAG -> ACTGGGCTTTTAGCATAGT
GAGAAATGTATCCTAACGC -> AGAAATGTATCCTAACGCT
GAGAACAGTTTTGTTCATG -> AGAACAGTTTTGTTCATGG
GAGAATCACAGCCGGGTAG -> AGAATCACAGCCGGGTAGT
GAGACAGGAATCTTTGTGG -> AGACAGGAATCTTTGTGGG
GAGAGTGAAACAATGGAAA -> AGAGTGAAACAATGGAAAA
GAGATCAGTCGAGCTTTCT -> AGATCAGTCGAGCTTTCTA
GAGATTGGGCACCACATAA -> AGATTGGGCACCACATAAG
GAGCAAAACACGCCCGAGC -> AGCAAAACACGCCCGAGCG
GAGCATTGCCTTTGTCTCC -> AGCATTGCCTTTGTCTCCT
GAGCCCCTACAAGTCTATA -> AGCCCCTACAAGTCTATAA
GAGCCTGACGTATTAACAG -> AGCCTGACGTATTAACAGC
GAGCGGATATGTTCTGAGC -> AGCGGATATGTTCTGAGCA
GAGCGGGAGTACCCACTGG -> AGCGGGAGTACCCACTGGT
GAGCGTGCCCAGGTACAAT -> AGCGTGCCCAGGTACAATC
GAGCGTGGAGCGTGCCCAG -> AGCGTGGAGCGTGCCCAGG
GAGCTTTCTAGCACGACTG -> AGCTTTCTAGCACGACTGG
GAGGCGGCCCTCTGGAGGG -> AGGCGGCCCTCTGGAGGGA
GAGGGACCTCCAAGAGACA -> AGGGACCTCCAAGAGACAG
GAGGGGCTCTCACGTCAGC -> AGGGGCTCTCACGTCAGCA
GAGGGTGATTAACCATAAC -> AGGGTGATTAACCATAACC
GAGGGTTATGCGGCTAACG -> AGGGTTATGCGGCTAACGT
GAGGTAAATTCCTAAGAAC -> AGGTAAATTCCTAAGAACA
GAGGTCAGTATTGTAGCCC -> AGGTCAGTATTGTAGCCCG
GAGGTGCGTCAATCTGGAC -> AGGTGCGTCAATCTGGACG
GAGTACCCACTGGTACCTA -> AGTACCCACTGGTACCTAT
GAGTGAAACAATGGAAAAC -> AGTGAAACAATGGAAAACT
GAGTGCCCCCTTTCAGTTT -> AGTGCCCCCTTTCAGTTTT
GAGTGTTTTTGAAGGACGT -> AGTGTTTTTGAAGGACGTT
GAGTTCAAACTGCTGGCAT -> AGTTCAAACTGCTGGCATA
GATAATAGGATATCAGGTA -> ATAATAGGATATCAGGTAT
GATAATCAGAGAGTGAAAC -> ATAATCAGAGAGTGAAACA
GATACCGTGGCTGCCCTTA -> ATACCGTGGCTGCCCTTAA
GATACGAAAGTTGGCACAG -> ATACGAAAGTTGGCACAGA
GATACGCCGTATTGACACA -> ATACGCCGTATTGACACAT
GATAGCTAGGGCTACCCTG -> ATAGCTAGGGCTACCCTGG
GATAGTCTTTCAACGTAGA -> ATAGTCTTTCAACGTAGAA
GATATCAGGTATTCGCCCT -> ATATCAGGTATTCGCCCTT
GATATCGGTGGGGCATCTG -> ATATCGGTGGGGCATCTGC
GATATGTTCTGAGCATTGC -> ATATGTTCTGAGCATTGCC
GATCAGTCGAGCTTTCTAG -> ATCAGTCGAGCTTTCTAGC
GATCCAATGAGTGTTTTTG -> ATCCAATGAGTGTTTTTGA
GATCCAGCTCCCTTGGACA -> ATCCAGCTCCCTTGGACAC
GATCGTAGACACATGCACT -> ATCGTAGACACATGCACTC
GATCTAAAGTGGCAAATCA -> ATCTAAAGTGGCAAATCAT
GATCTGGGAAAATCGGAAT -> ATCTGGGAAAATCGGAATT
GATGAAGTAGCGCCAGTTG -> ATGAAGTAGCGCCAGTTGG
GATGATGGGAGAACAGTTT -> ATGATGGGAGAACAGTTTT
GATGCAAGGCCGTCAGCAG -> ATGCAAGGCCGTCAGCAGG
GATGCGGCTAGGGTTGGCT -> ATGCGGCTAGGGTTGGCTG
GATGGGAGAACAGTTTTGT -> ATGGGAGAACAGTTTTGTT
GATGGGCAGAAAATGACTG -> ATGGGCAGAAAATGACTGG
GATGTCCCAGGCAGAGGGT -> ATGTCCCAGGCAGAGGGTT
GATGTGTCAGATGCAAGGC -> ATGTGTCAGATGCAAGGCC
GATTAACACCACGGCAGTC -> ATTAACACCACGGCAGTCA
GATTAACCATAACCAGCAA -> ATTAACCATAACCAGCAAG
GATTCTTGGTCGGACACGC -> ATTCTTGGTCGGACACGCT
GATTGATAATAGGATATCA -> ATTGATAATAGGATATCAG
GATTGGGCACCACATAAGG -> ATTGGGCACCACATAAGGC
GATTGGTAAGCGTCATCGC -> ATTGGTAAGCGTCATCGCC
GATTTAGAGAAATGTATCC -> ATTTAGAGAAATGTATCCT
GATTTGCTCTGGAGGTGCG -> ATTTGCTCTGGAGGTGCGT
GCAAAACACGCCCGAGCGG -> CAAAACACGCCCGAGCGGA
GCAAAATCAATAGGGCAGA -> CAAAATCAATAGGGCAGAA
GCAAACGAATGTCCCTACC -> CAAACGAATGTCCCTACCT
GCAAAGTTGAAGTTCCGTG -> CAAAGTTGAAGTTCCGTGT
GCAAATCATTAGCCCCGTC -> CAAATCATTAGCCCCGTCA
GCAACGTATACACATGAGG -> CAACGTATACACATGAGGT
GCAAGATACGAAAGTTGGC -> CAAGATACGAAAGTTGGCA
GCAAGGCCGTCAGCAGGTT -> CAAGGCCGTCAGCAGGTTC
GCAAGGGCCCAATCGCCGC -> CAAGGGCCCAATCGCCGCG
GCACACTTCGGGGGACATC -> CACACTTCGGGGGACATCA
GCACAGAAAAACTGCGAAA -> CACAGAAAAACTGCGAAAG
GCACAGCCTTGCGTCTCTA -> CACAGCCTTGCGTCTCTAA
GCACCACATAAGGCGCGTG -> CACCACATAAGGCGCGTGG
GCACCGGTGAATAGCGGGG -> CACCGGTGAATAGCGGGGG
GCACGACTGGGCTTTTAGC -> CACGACTGGGCTTTTAGCA
GCACTCATAGCTGGCGCGA -> CACTCATAGCTGGCGCGAG
GCAGAAAATGACTGGAAGT -> CAGAAAATGACTGGAAGTA
GCAGAAAATGACTGGACGA -> CAGAAAATGACTGGACGAC
GCAGAAAATGACTGGAGTG -> CAGAAAATGACTGGAGTGC
GCAGAAAATGACTGGATGA -> CAGAAAATGACTGGATGAT
GCAGAGGGTTATGCGGCTA -> CAGAGGGTTATGCGGCTAA
GCAGATGGGCAGAAAATGA -> CAGATGGGCAGAAAATGAC
GCAGATTCTTGGTCGGACA -> CAGATTCTTGGTCGGACAC
GCAGGTAGAATCTATATTA -> CAGGTAGAATCTATATTAT
GCAGGTTCTACCGTGCCCT -> CAGGTTCTACCGTGCCCTC
GCAGTCAGTGCGACCGTCG -> CAGTCAGTGCGACCGTCGG
GCAGTGGCCAAGCGGGGGG -> CAGTGGCCAAGCGGGGGGC
GCAGTTTTGTTCATGGGAC -> CAGTTTTGTTCATGGGACA
GCATACGGGATTGATAATA -> CATACGGGATTGATAATAG
GCATAGTCCACGAGCAAAA -> CATAGTCCACGAGCAAAAC
GCATCTGCTTACTGTGATG -> CATCTGCTTACTGTGATGT
GCATCTGGCCCCGATACCG -> CATCTGGCCCCGATACCGT
GCATGCGACAAGCACAGCC -> CATGCGACAAGCACAGCCT
GCATGGAAAGCATGCGACA -> CATGGAAAGCATGCGACAA
GCATGGCGCTCCATCGGGG -> CATGGCGCTCCATCGGGGC
GCATTGCCTTTGTCTCCTG -> CATTGCCTTTGTCTCCTGT
GCCAACATCCATCCCTGTC -> CCAACATCCATCCCTGTCG
GCCAACTTAACGTTATCAA -> CCAACTTAACGTTATCAAG
GCCAAGCGGGGGGCTTGAA -> CCAAGCGGGGGGCTTGAAT
GCCAATTGTGTCCTATTGT -> CCAATTGTGTCCTATTGTG
GCCAGGCCTGGGCAAGATA -> CCAGGCCTGGGCAAGATAC
GCCAGTTGGACCTCCCACG -> CCAGTTGGACCTCCCACGT
GCCAGTTTTGTTCATGGGA -> CCAGTTTTGTTCATGGGAC
GCCATCCTTCTGATAGCTA -> CCATCCTTCTGATAGCTAG
GCCCAATCGCCGCGTTTCA -> CCCAATCGCCGCGTTTCAA
GCCCAGGTACAATCCTTAC -> CCCAGGTACAATCCTTACG
GCCCATATTCTGGGTCACT -> CCCATATTCTGGGTCACTA
GCCCCATTGAATACGCTCA -> CCCCATTGAATACGCTCAG
GCCCCCTTTCAGTTTTGTT -> CCCCCTTTCAGTTTTGTTC
GCCCCGATACCGTGGCTGC -> CCCCGATACCGTGGCTGCC
GCCCCGTCAAGGAAGTCTG -> CCCCGTCAAGGAAGTCTGA
GCCCCTACAAGTCTATAAA -> CCCCTACAAGTCTATAAAC
GCCCGAGCGGATATGTTCT -> CCCGAGCGGATATGTTCTG
GCCCGCAGGTAGAATCTAT -> CCCGCAGGTAGAATCTATA
GCCCGCCGTTTCAATGTAA -> CCCGCCGTTTCAATGTAAG
GCCCGTCCTATGACATGGG -> CCCGTCCTATGACATGGGG
GCCCTCCAAGGCGGCCAAC -> CCCTCCAAGGCGGCCAACA
GCCCTCTGGAGGGACCTCC -> CCCTCTGGAGGGACCTCCA
GCCCTTAATCAAGGGCCGT -> CCCTTAATCAAGGGCCGTG
GCCCTTAATTGACGCGGTA -> CCCTTAATTGACGCGGTAA
GCCGATTTGCTCTGGAGGT -> CCGATTTGCTCTGGAGGTG
GCCGCGTTTCAAGGCGAGA -> CCGCGTTTCAAGGCGAGAT
GCCGGGTAGTGGTCGCATG -> CCGGGTAGTGGTCGCATGG
GCCGTAAGCCCGCAGGTAG -> CCGTAAGCCCGCAGGTAGA
GCCGTATTGACACATCTCA -> CCGTATTGACACATCTCAA
GCCGTCAGCAGGTTCTACC -> CCGTCAGCAGGTTCTACCG
GCCGTGCATGGAAAGCATG -> CCGTGCATGGAAAGCATGC
GCCGTGCCTGGGAGGGGCT -> CCGTGCCTGGGAGGGGCTC
GCCGTTTCAATGTAAGGGG -> CCGTTTCAATGTAAGGGGC
GCCTCAGCGGGCAGAAAAT -> CCTCAGCGGGCAGAAAATG
GCCTCCTCCGCGAATGATA -> CCTCCTCCGCGAATGATAC
GCCTGACGTATTAACAGCA -> CCTGACGTATTAACAGCAC
GCCTGGGAGGGGCTCTCAC -> CCTGGGAGGGGCTCTCACG
GCCTGGGCAAGATACGAAA -> CCTGGGCAAGATACGAAAG
GCCTTCTGTGTGAATGTTA -> CCTTCTGTGTGAATGTTAT
GCCTTGCGTCTCTAAACTC -> CCTTGCGTCTCTAAACTCG
GCCTTTGTCTCCTGTATCG -> CCTTTGTCTCCTGTATCGT
GCGAAAGACCACTGAACGG -> CGAAAGACCACTGAACGGG
GCGAATGATACGCCGTATT -> CGAATGATACGCCGTATTG
GCGACAAGCACAGCCTTGC -> CGACAAGCACAGCCTTGCG
GCGACACCGCAGATTCTTG -> CGACACCGCAGATTCTTGG
GCGACCGTCGGATCTAAAG -> CGACCGTCGGATCTAAAGT
GCGAGATCAGTCGAGCTTT -> CGAGATCAGTCGAGCTTTC
GCGAGCGGGAGTACCCACT -> CGAGCGGGAGTACCCACTG
GCGCCAGTTGGACCTCCCA -> CGCCAGTTGGACCTCCCAC
GCGCGAGCGGGAGTACCCA -> CGCGAGCGGGAGTACCCAC
GCGCGTGGGCAAAGTTGAA -> CGCGTGGGCAAAGTTGAAG
GCGCTACTAGGTTAACATA -> CGCTACTAGGTTAACATAC
GCGCTCCATCGGGGCAGAA -> CGCTCCATCGGGGCAGAAA
GCGGATATGTTCTGAGCAT -> CGGATATGTTCTGAGCATT
GCGGATCCAGCTCCCTTGG -> CGGATCCAGCTCCCTTGGA
GCGGCCAACATCCATCCCT -> CGGCCAACATCCATCCCTG
GCGGCCCTCTGGAGGGACC -> CGGCCCTCTGGAGGGACCT
GCGGCTAACGTGGCGCTAC -> CGGCTAACGTGGCGCTACT
GCGGCTAGGGTTGGCTGGA -> CGGCTAGGGTTGGCTGGAC
GCGGGAGTACCCACTGGTA -> CGGGAGTACCCACTGGTAC
GCGGGCAGAAAATGACTGG -> CGGGCAGAAAATGACTGGA
GCGGGGGATATCGGTGGGG -> CGGGGGATATCGGTGGGGC
GCGGGGGGCTTGAATGTGG -> CGGGGGGCTTGAATGTGGG
GCGGGTGCCTCAGCGGGCA -> CGGGTGCCTCAGCGGGCAG
GCGGTAACCACATCAAACG -> CGGTAACCACATCAAACGC
GCGGTAATAAACTCGGGTA -> CGGTAATAAACTCGGGTAC
GCGTCAATCTGGACGAGCC -> CGTCAATCTGGACGAGCCT
GCGTCATCGCCCCATTGAA -> CGTCATCGCCCCATTGAAT
GCGTCTCTAAACTCGGGTA -> CGTCTCTAAACTCGGGTAA
GCGTGCCCAGGTACAATCC -> CGTGCCCAGGTACAATCCT
GCGTGGAGCGTGCCCAGGT -> CGTGGAGCGTGCCCAGGTA
GCGTGGGCAAAGTTGAAGT -> CGTGGGCAAAGTTGAAGTT
GCGTTACGGATTAACACCA -> CGTTACGGATTAACACCAC
GCGTTTCAAGGCGAGATCA -> CGTTTCAAGGCGAGATCAG
GCTAAAGGGCTAGCTTGAA -> CTAAAGGGCTAGCTTGAAA
GCTAACGTGGCGCTACTAG -> CTAACGTGGCGCTACTAGG
GCTACCCTGGAGGGTGATT -> CTACCCTGGAGGGTGATTA
GCTACCGATGAAGTAGCGC -> CTACCGATGAAGTAGCGCC
GCTACTAGGTTAACATACT -> CTACTAGGTTAACATACTG
GCTAGCTTGAAACTTAGTG -> CTAGCTTGAAACTTAGTGT
GCTAGGGCTACCCTGGAGG -> CTAGGGCTACCCTGGAGGG
GCTAGGGCTCGGACCTGGA -> CTAGGGCTCGGACCTGGAT
GCTAGGGTTGGCTGGACCA -> CTAGGGTTGGCTGGACCAT
GCTCAGAGTTCAAACTGCT -> CTCAGAGTTCAAACTGCTG
GCTCCATCGGGGCAGAAAA -> CTCCATCGGGGCAGAAAAT
GCTCCCTTGGACACTTTGA -> CTCCCTTGGACACTTTGAA
GCTCGGACCTGGATAATCA -> CTCGGACCTGGATAATCAG
GCTCTCACGTCAGCAACGT -> CTCTCACGTCAGCAACGTA
GCTCTGGAGGTGCGTCAAT -> CTCTGGAGGTGCGTCAATC
GCTGCAGTTTTGTTCATGG -> CTGCAGTTTTGTTCATGGG
GCTGCCAGTTTTGTTCATG -> CTGCCAGTTTTGTTCATGG
GCTGCCCTTAATTGACGCG -> CTGCCCTTAATTGACGCGG
GCTGGACCATAAGGCGTTA -> CTGGACCATAAGGCGTTAC
GCTGGCATACGGGATTGAT -> CTGGCATACGGGATTGATA
GCTGGCGCGAGCGGGAGTA -> CTGGCGCGAGCGGGAGTAC
GCTTACTGTGATGTGTCAG -> CTTACTGTGATGTGTCAGA
GCTTGAAACTTAGTGTAGT -> CTTGAAACTTAGTGTAGTA
GCTTGAATGTGGGTGTTCA -> CTTGAATGTGGGTGTTCAA
GCTTTCTAGCACGACTGGG -> CTTTCTAGCACGACTGGGC
GCTTTTAGCATAGTCCACG -> CTTTTAGCATAGTCCACGA
GCTTTTCGGTGCAGTGGCC -> CTTTTCGGTGCAGTGGCCA
GGAAAACTCGGTCCAGGCG -> GAAAACTCGGTCCAGGCGA
GGAAAATCGGAATTCAAAT -> GAAAATCGGAATTCAAATA
GGAAAGCATGCGACAAGCA -> GAAAGCATGCGACAAGCAC
GGAAAGCCTCCTCCGCGAA -> GAAAGCCTCCTCCGCGAAT
GGAACTGTGCCGTGCCTGG -> GAACTGTGCCGTGCCTGGG
GGAAGTATTGGCTGCAGTT -> GAAGTATTGGCTGCAGTTT
GGAAGTCTGAGATTGGGCA -> GAAGTCTGAGATTGGGCAC
GGAATCTCGCGGGTGCCTC -> GAATCTCGCGGGTGCCTCA
GGAATCTTTGTGGGCTATT -> GAATCTTTGTGGGCTATTA
GGAATTCAAATACATGATT -> GAATTCAAATACATGATTG
GGACAACAATTTGATTTAG -> GACAACAATTTGATTTAGA
GGACACGCTAAAGGGCTAG -> GACACGCTAAAGGGCTAGC
GGACACTACACAAACGGCC -> GACACTACACAAACGGCCA
GGACACTTTGAACCCTGAC -> GACACTTTGAACCCTGACA
GGACAGTTGATAGTCTTTC -> GACAGTTGATAGTCTTTCA
GGACATATAGATCGTAGAC -> GACATATAGATCGTAGACA
GGACATCAAGATGTCCCAG -> GACATCAAGATGTCCCAGG
GGACCATAAGGCGTTACGG -> GACCATAAGGCGTTACGGA
GGACCTCCAAGAGACAGGA -> GACCTCCAAGAGACAGGAA
GGACCTCCCACGTGCCGTA -> GACCTCCCACGTGCCGTAA
GGACCTGGATAATCAGAGA -> GACCTGGATAATCAGAGAG
GGACGACTGGCTGCCAGTT -> GACGACTGGCTGCCAGTTT
GGACGAGCCTGACGTATTA -> GACGAGCCTGACGTATTAA
GGACGCACACTTCGGGGGA -> GACGCACACTTCGGGGGAC
GGACGCCTTCTGTGTGAAT -> GACGCCTTCTGTGTGAATG
GGACGTTGAGCCCCTACAA -> GACGTTGAGCCCCTACAAG
GGAGAACAGTTTTGTTCAT -> GAGAACAGTTTTGTTCATG
GGAGCGTGCCCAGGTACAA -> GAGCGTGCCCAGGTACAAT
GGAGGCGGCCCTCTGGAGG -> GAGGCGGCCCTCTGGAGGG
GGAGGGACCTCCAAGAGAC -> GAGGGACCTCCAAGAGACA
GGAGGGGCTCTCACGTCAG -> GAGGGGCTCTCACGTCAGC
GGAGGGTGATTAACCATAA -> GAGGGTGATTAACCATAAC
GGAGGTGCGTCAATCTGGA -> GAGGTGCGTCAATCTGGAC
GGAGTACCCACTGGTACCT -> GAGTACCCACTGGTACCTA
GGAGTGCCCCCTTTCAGTT -> GAGTGCCCCCTTTCAGTTT
GGATAATCAGAGAGTGAAA -> GATAATCAGAGAGTGAAAC
GGATATCAGGTATTCGCCC -> GATATCAGGTATTCGCCCT
GGATATCGGTGGGGCATCT -> GATATCGGTGGGGCATCTG
GGATATGTTCTGAGCATTG -> GATATGTTCTGAGCATTGC
GGATCCAATGAGTGTTTTT -> GATCCAATGAGTGTTTTTG
GGATCCAGCTCCCTTGGAC -> GATCCAGCTCCCTTGGACA
GGATCTAAAGTGGCAAATC -> GATCTAAAGTGGCAAATCA
GGATCTGGGAAAATCGGAA -> GATCTGGGAAAATCGGAAT
GGATGATGGGAGAACAGTT -> GATGATGGGAGAACAGTTT
GGATTAACACCACGGCAGT -> GATTAACACCACGGCAGTC
GGATTGATAATAGGATATC -> GATTGATAATAGGATATCA
GGCAAAGTTGAAGTTCCGT -> GCAAAGTTGAAGTTCCGTG
GGCAAATCATTAGCCCCGT -> GCAAATCATTAGCCCCGTC
GGCAAGATACGAAAGTTGG -> GCAAGATACGAAAGTTGGC
GGCACAGAAAAACTGCGAA -> GCACAGAAAAACTGCGAAA
GGCACCACATAAGGCGCGT -> GCACCACATAAGGCGCGTG
GGCAGAAAATGACTGGAAG -> GCAGAAAATGACTGGAAGT
GGCAGAAAATGACTGGACG -> GCAGAAAATGACTGGACGA
GGCAGAAAATGACTGGAGT -> GCAGAAAATGACTGGAGTG
GGCAGAAAATGACTGGATG -> GCAGAAAATGACTGGATGA
GGCAGAGGGTTATGCGGCT -> GCAGAGGGTTATGCGGCTA
GGCAGTCAGTGCGACCGTC -> GCAGTCAGTGCGACCGTCG
GGCATACGGGATTGATAAT -> GCATACGGGATTGATAATA
GGCATCTGCTTACTGTGAT -> GCATCTGCTTACTGTGATG
GGCCAACATCCATCCCTGT -> GCCAACATCCATCCCTGTC
GGCCAAGCGGGGGGCTTGA -> GCCAAGCGGGGGGCTTGAA
GGCCAGGCCTGGGCAAGAT -> GCCAGGCCTGGGCAAGATA
GGCCCAATCGCCGCGTTTC -> GCCCAATCGCCGCGTTTCA
GGCCCATATTCTGGGTCAC -> GCCCATATTCTGGGTCACT
GGCCCCGATACCGTGGCTG -> GCCCCGATACCGTGGCTGC
GGCCCTCTGGAGGGACCTC -> GCCCTCTGGAGGGACCTCC
GGCCGTCAGCAGGTTCTAC -> GCCGTCAGCAGGTTCTACC
GGCCGTGCATGGAAAGCAT -> GCCGTGCATGGAAAGCATG
GGCCTGGGCAAGATACGAA -> GCCTGGGCAAGATACGAAA
GGCGACACCGCAGATTCTT -> GCGACACCGCAGATTCTTG
GGCGAGATCAGTCGAGCTT -> GCGAGATCAGTCGAGCTTT
GGCGCGAGCGGGAGTACCC -> GCGCGAGCGGGAGTACCCA
GGCGCGTGGGCAAAGTTGA -> GCGCGTGGGCAAAGTTGAA
GGCGCTACTAGGTTAACAT -> GCGCTACTAGGTTAACATA
GGCGCTCCATCGGGGCAGA -> GCGCTCCATCGGGGCAGAA
GGCGGCCAACATCCATCCC -> GCGGCCAACATCCATCCCT
GGCGGCCCTCTGGAGGGAC -> GCGGCCCTCTGGAGGGACC
GGCGTTACGGATTAACACC -> GCGTTACGGATTAACACCA
GGCTAACGTGGCGCTACTA -> GCTAACGTGGCGCTACTAG
GGCTACCCTGGAGGGTGAT -> GCTACCCTGGAGGGTGATT
GGCTAGCTTGAAACTTAGT -> GCTAGCTTGAAACTTAGTG
GGCTAGGGCTCGGACCTGG -> GCTAGGGCTCGGACCTGGA
GGCTAGGGTTGGCTGGACC -> GCTAGGGTTGGCTGGACCA
GGCTCGGACCTGGATAATC -> GCTCGGACCTGGATAATCA
GGCTCTCACGTCAGCAACG -> GCTCTCACGTCAGCAACGT
GGCTGCAGTTTTGTTCATG -> GCTGCAGTTTTGTTCATGG
GGCTGCCAGTTTTGTTCAT -> GCTGCCAGTTTTGTTCATG
GGCTGCCCTTAATTGACGC -> GCTGCCCTTAATTGACGCG
GGCTGGACCATAAGGCGTT -> GCTGGACCATAAGGCGTTA
GGCTTGAATGTGGGTGTTC -> GCTTGAATGTGGGTGTTCA
GGCTTTTAGCATAGTCCAC -> GCTTTTAGCATAGTCCACG
GGGAAAATCGGAATTCAAA -> GGAAAATCGGAATTCAAAT
GGGAACTGTGCCGTGCCTG -> GGAACTGTGCCGTGCCTGG
GGGACAACAATTTGATTTA -> GGACAACAATTTGATTTAG
GGGACACTACACAAACGGC -> GGACACTACACAAACGGCC
GGGACAGTTGATAGTCTTT -> GGACAGTTGATAGTCTTTC
GGGACATATAGATCGTAGA -> GGACATATAGATCGTAGAC
GGGACATCAAGATGTCCCA -> GGACATCAAGATGTCCCAG
GGGACCTCCAAGAGACAGG -> GGACCTCCAAGAGACAGGA
GGGACGCCTTCTGTGTGAA -> GGACGCCTTCTGTGTGAAT
GGGAGAACAGTTTTGTTCA -> GGAGAACAGTTTTGTTCAT
GGGAGGGGCTCTCACGTCA -> GGAGGGGCTCTCACGTCAG
GGGAGTACCCACTGGTACC -> GGAGTACCCACTGGTACCT
GGGATATCGGTGGGGCATC -> GGATATCGGTGGGGCATCT
GGGATCCAATGAGTGTTTT -> GGATCCAATGAGTGTTTTT
GGGATTGATAATAGGATAT -> GGATTGATAATAGGATATC
GGGCAAAGTTGAAGTTCCG -> GGCAAAGTTGAAGTTCCGT
GGGCAAGATACGAAAGTTG -> GGCAAGATACGAAAGTTGG
GGGCACCACATAAGGCGCG -> GGCACCACATAAGGCGCGT
GGGCAGAAAATGACTGGAA -> GGCAGAAAATGACTGGAAG
GGGCAGAAAATGACTGGAC -> GGCAGAAAATGACTGGACG
GGGCAGAAAATGACTGGAG -> GGCAGAAAATGACTGGAGT
GGGCAGAAAATGACTGGAT -> GGCAGAAAATGACTGGATG
GGGCATCTGCTTACTGTGA -> GGCATCTGCTTACTGTGAT
GGGCCCAATCGCCGCGTTT -> GGCCCAATCGCCGCGTTTC
GGGCCCATATTCTGGGTCA -> GGCCCATATTCTGGGTCAC
GGGCCGTGCATGGAAAGCA -> GGCCGTGCATGGAAAGCAT
GGGCTACCCTGGAGGGTGA -> GGCTACCCTGGAGGGTGAT
GGGCTAGCTTGAAACTTAG -> GGCTAGCTTGAAACTTAGT
GGGCTAGGGCTCGGACCTG -> GGCTAGGGCTCGGACCTGG
GGGCTCGGACCTGGATAAT -> GGCTCGGACCTGGATAATC
GGGCTCTCACGTCAGCAAC -> GGCTCTCACGTCAGCAACG
GGGCTTGAATGTGGGTGTT -> GGCTTGAATGTGGGTGTTC
GGGCTTTTAGCATAGTCCA -> GGCTTTTAGCATAGTCCAC
GGGGAACTGTGCCGTGCCT -> GGGAACTGTGCCGTGCCTG
GGGGACATCAAGATGTCCC -> GGGACATCAAGATGTCCCA
GGGGATATCGGTGGGGCAT -> GGGATATCGGTGGGGCATC
GGGGCAGAAAATGACTGGA -> GGGCAGAAAATGACTGGAG
GGGGCATCTGCTTACTGTG -> GGGCATCTGCTTACTGTGA
GGGGCCCATATTCTGGGTC -> GGGCCCATATTCTGGGTCA
GGGGCTAGGGCTCGGACCT -> GGGCTAGGGCTCGGACCTG
GGGGCTCTCACGTCAGCAA -> GGGCTCTCACGTCAGCAAC
GGGGCTTGAATGTGGGTGT -> GGGCTTGAATGTGGGTGTT
GGGGGACATCAAGATGTCC -> GGGGACATCAAGATGTCCC
GGGGGATATCGGTGGGGCA -> GGGGATATCGGTGGGGCAT
GGGGGCTTGAATGTGGGTG -> GGGGCTTGAATGTGGGTGT
GGGGGGCTTGAATGTGGGT -> GGGGGCTTGAATGTGGGTG
GGGTAAATCACGCAAAATC -> GGTAAATCACGCAAAATCA
GGGTACCTCTAATGGTCTA -> GGTACCTCTAATGGTCTAC
GGGTAGTGGTCGCATGGCG -> GGTAGTGGTCGCATGGCGC
GGGTCACTACAGTTGTCAA -> GGTCACTACAGTTGTCAAC
GGGTGATTAACCATAACCA -> GGTGATTAACCATAACCAG
GGGTGCCTCAGCGGGCAGA -> GGTGCCTCAGCGGGCAGAA
GGGTGTTCAAAAAGCATCT -> GGTGTTCAAAAAGCATCTG
GGGTTATGCGGCTAACGTG -> GGTTATGCGGCTAACGTGG
GGGTTGGCTGGACCATAAG -> GGTTGGCTGGACCATAAGG
GGTAAATCACGCAAAATCA -> GTAAATCACGCAAAATCAA
GGTAAATTCCTAAGAACAA -> GTAAATTCCTAAGAACAAA
GGTAACCACATCAAACGCC -> GTAACCACATCAAACGCCC
GGTAAGCGTCATCGCCCCA -> GTAAGCGTCATCGCCCCAT
GGTAATAAACTCGGGTACC -> GTAATAAACTCGGGTACCT
GGTACAATCCTTACGACAT -> GTACAATCCTTACGACATG
GGTACCTATACTCCCGTGA -> GTACCTATACTCCCGTGAC
GGTACCTCTAATGGTCTAC -> GTACCTCTAATGGTCTACG
GGTACGTTATACAGGACGC -> GTACGTTATACAGGACGCA
GGTAGAATCTATATTATGG -> GTAGAATCTATATTATGGG
GGTAGTGGTCGCATGGCGC -> GTAGTGGTCGCATGGCGCT
GGTATTCGCCCTTAATCAA -> GTATTCGCCCTTAATCAAG
GGTCACTACAGTTGTCAAC -> GTCACTACAGTTGTCAACT
GGTCAGTATTGTAGCCCGT -> GTCAGTATTGTAGCCCGTC
GGTCATACCGTGAGGTCAG -> GTCATACCGTGAGGTCAGT
GGTCCAGGCGACACCGCAG -> GTCCAGGCGACACCGCAGA
GGTCGCATGGCGCTCCATC -> GTCGCATGGCGCTCCATCG
GGTCGGACACGCTAAAGGG -> GTCGGACACGCTAAAGGGC
GGTCTACGGGACGCCTTCT -> GTCTACGGGACGCCTTCTG
GGTCTCATAGCCAACTTAA -> GTCTCATAGCCAACTTAAC
GGTCTCGGATCTGGGAAAA -> GTCTCGGATCTGGGAAAAT
GGTGAATAGCGGGGGATAT -> GTGAATAGCGGGGGATATC
GGTGATTAACCATAACCAG -> GTGATTAACCATAACCAGC
GGTGCAGTGGCCAAGCGGG -> GTGCAGTGGCCAAGCGGGG
GGTGCCTCAGCGGGCAGAA -> GTGCCTCAGCGGGCAGAAA
GGTGCGTCAATCTGGACGA -> GTGCGTCAATCTGGACGAG
GGTGGGGCATCTGCTTACT -> GTGGGGCATCTGCTTACTG
GGTGTTCAAAAAGCATCTG -> GTGTTCAAAAAGCATCTGG
GGTTAACATACTGCTACCG -> GTTAACATACTGCTACCGA
GGTTATGCGGCTAACGTGG -> GTTATGCGGCTAACGTGGC
GGTTCTACCGTGCCCTCCA -> GTTCTACCGTGCCCTCCAA
GGTTGGCTGGACCATAAGG -> GTTGGCTGGACCATAAGGC
GTAAATCACGCAAAATCAA -> TAAATCACGCAAAATCAAT
GTAAATTCCTAAGAACAAA -> TAAATTCCTAAGAACAAAA
GTAACCACATCAAACGCCC -> TAACCACATCAAACGCCCG
GTAAGCCCGCAGGTAGAAT -> TAAGCCCGCAGGTAGAATC
GTAAGCGTCATCGCCCCAT -> TAAGCGTCATCGCCCCATT
GTAAGGGGCTAGGGCTCGG -> TAAGGGGCTAGGGCTCGGA
GTAATAAACTCGGGTACCT -> TAATAAACTCGGGTACCTC
GTACAATCCTTACGACATG -> TACAATCCTTACGACATGA
GTACCCACTGGTACCTATA -> TACCCACTGGTACCTATAC
GTACCGATGCGGCTAGGGT -> TACCGATGCGGCTAGGGTT
GTACCTATACTCCCGTGAC -> TACCTATACTCCCGTGACC
GTACCTCTAATGGTCTACG -> TACCTCTAATGGTCTACGG
GTACGTTATACAGGACGCA -> TACGTTATACAGGACGCAC
GTAGAATCCTATTGCGGTA -> TAGAATCCTATTGCGGTAA
GTAGAATCTATATTATGGG -> TAGAATCTATATTATGGGG
GTAGACACATGCACTCATA -> TAGACACATGCACTCATAG
GTAGCCCGTCCTATGACAT -> TAGCCCGTCCTATGACATG
GTAGCGCCAGTTGGACCTC -> TAGCGCCAGTTGGACCTCC
GTAGGTCTCGGATCTGGGA -> TAGGTCTCGGATCTGGGAA
GTAGTAGGTCTCGGATCTG -> TAGTAGGTCTCGGATCTGG
GTAGTGGTCGCATGGCGCT -> TAGTGGTCGCATGGCGCTC
GTATACACATGAGGTAAAT -> TATACACATGAGGTAAATT
GTATCCTAACGCTTTTCGG -> TATCCTAACGCTTTTCGGT
GTATCGTCAGCCAATTGTG -> TATCGTCAGCCAATTGTGT
GTATGCCATCCTTCTGATA -> TATGCCATCCTTCTGATAG
GTATTAACAGCACCGGTGA -> TATTAACAGCACCGGTGAA
GTATTCGCCCTTAATCAAG -> TATTCGCCCTTAATCAAGG
GTATTGACACATCTCAAGG -> TATTGACACATCTCAAGGT
GTATTGGCTGCAGTTTTGT -> TATTGGCTGCAGTTTTGTT
GTATTGTAGCCCGTCCTAT -> TATTGTAGCCCGTCCTATG
GTCAACTCCCTGTTCAAAT -> TCAACTCCCTGTTCAAATT
GTCAAGGAAGTCTGAGATT -> TCAAGGAAGTCTGAGATTG
GTCAATCTGGACGAGCCTG -> TCAATCTGGACGAGCCTGA
GTCACTACAGTTGTCAACT -> TCACTACAGTTGTCAACTC
GTCAGATGCAAGGCCGTCA -> TCAGATGCAAGGCCGTCAG
GTCAGCAACGTATACACAT -> TCAGCAACGTATACACATG
GTCAGCAGGTTCTACCGTG -> TCAGCAGGTTCTACCGTGC
GTCAGCCAATTGTGTCCTA -> TCAGCCAATTGTGTCCTAT
GTCAGTATTGTAGCCCGTC -> TCAGTATTGTAGCCCGTCC
GTCAGTGCGACCGTCGGAT -> TCAGTGCGACCGTCGGATC
GTCATACCGTGAGGTCAGT -> TCATACCGTGAGGTCAGTA
GTCATCGCCCCATTGAATA -> TCATCGCCCCATTGAATAC
GTCCACGAGCAAAACACGC -> TCCACGAGCAAAACACGCC
GTCCAGGCGACACCGCAGA -> TCCAGGCGACACCGCAGAT
GTCCCAGGCAGAGGGTTAT -> TCCCAGGCAGAGGGTTATG
GTCCCTACCTCGTACCGAT -> TCCCTACCTCGTACCGATG
GTCCTATGACATGGGGAAC -> TCCTATGACATGGGGAACT
GTCCTATTGTGTTGGAATC -> TCCTATTGTGTTGGAATCT
GTCGAATTATTATCTCCAA -> TCGAATTATTATCTCCAAC
GTCGAGCTTTCTAGCACGA -> TCGAGCTTTCTAGCACGAC
GTCGCATGGCGCTCCATCG -> TCGCATGGCGCTCCATCGG
GTCGGACACGCTAAAGGGC -> TCGGACACGCTAAAGGGCT
GTCGGATCTAAAGTGGCAA -> TCGGATCTAAAGTGGCAAA
GTCGTATGCCATCCTTCTG -> TCGTATGCCATCCTTCTGA
GTCTACGGGACGCCTTCTG -> TCTACGGGACGCCTTCTGT
GTCTATAAACCAAAACGGA -> TCTATAAACCAAAACGGAG
GTCTCATAGCCAACTTAAC -> TCTCATAGCCAACTTAACG
GTCTCCTGTATCGTCAGCC -> TCTCCTGTATCGTCAGCCA
GTCTCGGATCTGGGAAAAT -> TCTCGGATCTGGGAAAATC
GTCTCTAAACTCGGGTAAA -> TCTCTAAACTCGGGTAAAT
GTCTGAGATTGGGCACCAC -> TCTGAGATTGGGCACCACA
GTCTTTCAACGTAGAATCC -> TCTTTCAACGTAGAATCCT
GTGAAACAATGGAAAACTC -> TGAAACAATGGAAAACTCG
GTGAATAGCGGGGGATATC -> TGAATAGCGGGGGATATCG
GTGAATGTTATATCCTAAT -> TGAATGTTATATCCTAATG
GTGACCCCCGAGCGTGGAG -> TGACCCCCGAGCGTGGAGC
GTGAGGTCAGTATTGTAGC -> TGAGGTCAGTATTGTAGCC
GTGATGTGTCAGATGCAAG -> TGATGTGTCAGATGCAAGG
GTGATTAACCATAACCAGC -> TGATTAACCATAACCAGCA
GTGCAGTGGCCAAGCGGGG -> TGCAGTGGCCAAGCGGGGG
GTGCATGGAAAGCATGCGA -> TGCATGGAAAGCATGCGAC
GTGCCCAGGTACAATCCTT -> TGCCCAGGTACAATCCTTA
GTGCCCCCTTTCAGTTTTG -> TGCCCCCTTTCAGTTTTGT
GTGCCCTCCAAGGCGGCCA -> TGCCCTCCAAGGCGGCCAA
GTGCCGTAAGCCCGCAGGT -> TGCCGTAAGCCCGCAGGTA
GTGCCGTGCCTGGGAGGGG -> TGCCGTGCCTGGGAGGGGC
GTGCCTCAGCGGGCAGAAA -> TGCCTCAGCGGGCAGAAAA
GTGCCTGGGAGGGGCTCTC -> TGCCTGGGAGGGGCTCTCA
GTGCGACCGTCGGATCTAA -> TGCGACCGTCGGATCTAAA
GTGCGTCAATCTGGACGAG -> TGCGTCAATCTGGACGAGC
GTGGAGCGTGCCCAGGTAC -> TGGAGCGTGCCCAGGTACA
GTGGCAAATCATTAGCCCC -> TGGCAAATCATTAGCCCCG
GTGGCCAAGCGGGGGGCTT -> TGGCCAAGCGGGGGGCTTG
GTGGCGCTACTAGGTTAAC -> TGGCGCTACTAGGTTAACA
GTGGCTGCCCTTAATTGAC -> TGGCTGCCCTTAATTGACG
GTGGGCAAAGTTGAAGTTC -> TGGGCAAAGTTGAAGTTCC
GTGGGGCATCTGCTTACTG -> TGGGGCATCTGCTTACTGT
GTGGGTGTTCAAAAAGCAT -> TGGGTGTTCAAAAAGCATC
GTGGTCGCATGGCGCTCCA -> TGGTCGCATGGCGCTCCAT
GTGTAGTAGGTCTCGGATC -> TGTAGTAGGTCTCGGATCT
GTGTCAGATGCAAGGCCGT -> TGTCAGATGCAAGGCCGTC
GTGTCCTATTGTGTTGGAA -> TGTCCTATTGTGTTGGAAT
GTGTGAATGTTATATCCTA -> TGTGAATGTTATATCCTAA
GTGTTATCCACTATCGCGG -> TGTTATCCACTATCGCGGA
GTGTTCAAAAAGCATCTGG -> TGTTCAAAAAGCATCTGGC
GTGTTGGAATCTCGCGGGT -> TGTTGGAATCTCGCGGGTG
GTGTTTTTGAAGGACGTTG -> TGTTTTTGAAGGACGTTGA
GTTAACATACTGCTACCGA -> TTAACATACTGCTACCGAT
GTTACGGATTAACACCACG -> TTACGGATTAACACCACGG
GTTATACAGGACGCACACT -> TTATACAGGACGCACACTT
GTTATATCCTAATGTCGAA -> TTATATCCTAATGTCGAAT
GTTATCAAGAGAATCACAG -> TTATCAAGAGAATCACAGC
GTTATCCACTATCGCGGAT -> TTATCCACTATCGCGGATC
GTTATGCGGCTAACGTGGC -> TTATGCGGCTAACGTGGCG
GTTCAAAAAGCATCTGGCC -> TTCAAAAAGCATCTGGCCC
GTTCAAACTGCTGGCATAC -> TTCAAACTGCTGGCATACG
GTTCAAATTTACTGGAAAG -> TTCAAATTTACTGGAAAGC
GTTCATGGGACAACAATTT -> TTCATGGGACAACAATTTG
GTTCATGGGACACTACACA -> TTCATGGGACACTACACAA
GTTCATGGGACAGTTGATA -> TTCATGGGACAGTTGATAG
GTTCATGGGACATATAGAT -> TTCATGGGACATATAGATC
GTTCCGTGTTATCCACTAT -> TTCCGTGTTATCCACTATC
GTTCTACCGTGCCCTCCAA -> TTCTACCGTGCCCTCCAAG
GTTCTGAGCATTGCCTTTG -> TTCTGAGCATTGCCTTTGT
GTTGAAGTTCCGTGTTATC -> TTGAAGTTCCGTGTTATCC
GTTGAGCCCCTACAAGTCT -> TTGAGCCCCTACAAGTCTA
GTTGATAGTCTTTCAACGT -> TTGATAGTCTTTCAACGTA
GTTGGAATCTCGCGGGTGC -> TTGGAATCTCGCGGGTGCC
GTTGGACCTCCCACGTGCC -> TTGGACCTCCCACGTGCCG
GTTGGCACAGAAAAACTGC -> TTGGCACAGAAAAACTGCG
GTTGGCTGGACCATAAGGC -> TTGGCTGGACCATAAGGCG
GTTGTCAACTCCCTGTTCA -> TTGTCAACTCCCTGTTCAA
GTTTCAAGGCGAGATCAGT -> TTTCAAGGCGAGATCAGTC
GTTTCAATGTAAGGGGCTA -> TTTCAATGTAAGGGGCTAG
GTTTTGTTCATGGGACAAC -> TTTTGTTCATGGGACAACA
GTTTTGTTCATGGGACACT -> TTTTGTTCATGGGACACTA
GTTTTGTTCATGGGACAGT -> TTTTGTTCATGGGACAGTT
GTTTTGTTCATGGGACATA -> TTTTGTTCATGGGACATAT
GTTTTTGAAGGACGTTGAG -> TTTTTGAAGGACGTTGAGC
TAAACCAAAACGGAGGCGG -> AAACCAAAACGGAGGCGGC
TAAACTCGGGTAAATCACG -> AAACTCGGGTAAATCACGC
TAAACTCGGGTACCTCTAA -> AAACTCGGGTACCTCTAAT
TAAAGGGCTAGCTTGAAAC -> AAAGGGCTAGCTTGAAACT
TAAAGTGGCAAATCATTAG -> AAAGTGGCAAATCATTAGC
TAAATCACGCAAAATCAAT -> AAATCACGCAAAATCAATA
TAAATTCCTAAGAACAAAA -> AAATTCCTAAGAACAAAAC
TAACACCACGGCAGTCAGT -> AACACCACGGCAGTCAGTG
TAACAGCACCGGTGAATAG -> AACAGCACCGGTGAATAGC
TAACATACTGCTACCGATG -> AACATACTGCTACCGATGA
TAACCACATCAAACGCCCG -> AACCACATCAAACGCCCGC
TAACCAGCAAGGGCCCAAT -> AACCAGCAAGGGCCCAATC
TAACCATAACCAGCAAGGG -> AACCATAACCAGCAAGGGC
TAACGCTTTTCGGTGCAGT -> AACGCTTTTCGGTGCAGTG
TAACGTGGCGCTACTAGGT -> AACGTGGCGCTACTAGGTT
TAACGTTATCAAGAGAATC -> AACGTTATCAAGAGAATCA
TAAGAACAAAACCTAGGTA -> AAGAACAAAACCTAGGTAC
TAAGCCCGCAGGTAGAATC -> AAGCCCGCAGGTAGAATCT
TAAGCGTCATCGCCCCATT -> AAGCGTCATCGCCCCATTG
TAAGGCGCGTGGGCAAAGT -> AAGGCGCGTGGGCAAAGTT
TAAGGCGTTACGGATTAAC -> AAGGCGTTACGGATTAACA
TAAGGGGCTAGGGCTCGGA -> AAGGGGCTAGGGCTCGGAC
TAATAAACTCGGGTACCTC -> AATAAACTCGGGTACCTCT
TAATAGGATATCAGGTATT -> AATAGGATATCAGGTATTC
TAATCAAGGGCCGTGCATG -> AATCAAGGGCCGTGCATGG
TAATCAGAGAGTGAAACAA -> AATCAGAGAGTGAAACAAT
TAATGGTCTACGGGACGCC -> AATGGTCTACGGGACGCCT
TAATGTCGAATTATTATCT -> AATGTCGAATTATTATCTC
TAATTGACGCGGTAACCAC -> AATTGACGCGGTAACCACA
TACAAGTCTATAAACCAAA -> ACAAGTCTATAAACCAAAA
TACAATCCTTACGACATGA -> ACAATCCTTACGACATGAA
TACACAAACGGCCAGGCCT -> ACACAAACGGCCAGGCCTG
TACACATGAGGTAAATTCC -> ACACATGAGGTAAATTCCT
TACAGGACGCACACTTCGG -> ACAGGACGCACACTTCGGG
TACAGTTGTCAACTCCCTG -> ACAGTTGTCAACTCCCTGT
TACATGATTGGTAAGCGTC -> ACATGATTGGTAAGCGTCA
TACCCACTGGTACCTATAC -> ACCCACTGGTACCTATACT
TACCCTGGAGGGTGATTAA -> ACCCTGGAGGGTGATTAAC
TACCGATGAAGTAGCGCCA -> ACCGATGAAGTAGCGCCAG
TACCGATGCGGCTAGGGTT -> ACCGATGCGGCTAGGGTTG
TACCGTGAGGTCAGTATTG -> ACCGTGAGGTCAGTATTGT
TACCGTGCCCTCCAAGGCG -> ACCGTGCCCTCCAAGGCGG
TACCGTGGCTGCCCTTAAT -> ACCGTGGCTGCCCTTAATT
TACCTATACTCCCGTGACC -> ACCTATACTCCCGTGACCC
TACCTCGTACCGATGCGGC -> ACCTCGTACCGATGCGGCT
TACCTCTAATGGTCTACGG -> ACCTCTAATGGTCTACGGG
TACGAAAGTTGGCACAGAA -> ACGAAAGTTGGCACAGAAA
TACGACATGAAATTTCGCA -> ACGACATGAAATTTCGCAA
TACGCCGTATTGACACATC -> ACGCCGTATTGACACATCT
TACGCTCAGAGTTCAAACT -> ACGCTCAGAGTTCAAACTG
TACGGATTAACACCACGGC -> ACGGATTAACACCACGGCA
TACGGGACGCCTTCTGTGT -> ACGGGACGCCTTCTGTGTG
TACGGGATTGATAATAGGA -> ACGGGATTGATAATAGGAT
TACGTTATACAGGACGCAC -> ACGTTATACAGGACGCACA
TACTAGGTTAACATACTGC -> ACTAGGTTAACATACTGCT
TACTCCCGTGACCCCCGAG -> ACTCCCGTGACCCCCGAGC
TACTGCTACCGATGAAGTA -> ACTGCTACCGATGAAGTAG
TACTGGAAAGCCTCCTCCG -> ACTGGAAAGCCTCCTCCGC
TACTGTGATGTGTCAGATG -> ACTGTGATGTGTCAGATGC
TAGAATCCTATTGCGGTAA -> AGAATCCTATTGCGGTAAT
TAGAATCTATATTATGGGG -> AGAATCTATATTATGGGGC
TAGACACATGCACTCATAG -> AGACACATGCACTCATAGC
TAGAGAAATGTATCCTAAC -> AGAGAAATGTATCCTAACG
TAGATCGTAGACACATGCA -> AGATCGTAGACACATGCAC
TAGCACGACTGGGCTTTTA -> AGCACGACTGGGCTTTTAG
TAGCATAGTCCACGAGCAA -> AGCATAGTCCACGAGCAAA
TAGCCAACTTAACGTTATC -> AGCCAACTTAACGTTATCA
TAGCCCCGTCAAGGAAGTC -> AGCCCCGTCAAGGAAGTCT
TAGCCCGTCCTATGACATG -> AGCCCGTCCTATGACATGG
TAGCGCCAGTTGGACCTCC -> AGCGCCAGTTGGACCTCCC
TAGCGGGGGATATCGGTGG -> AGCGGGGGATATCGGTGGG
TAGCTAGGGCTACCCTGGA -> AGCTAGGGCTACCCTGGAG
TAGCTGGCGCGAGCGGGAG -> AGCTGGCGCGAGCGGGAGT
TAGCTTGAAACTTAGTGTA -> AGCTTGAAACTTAGTGTAG
TAGGATATCAGGTATTCGC -> AGGATATCAGGTATTCGCC
TAGGGCAGAAAATGACTGG -> AGGGCAGAAAATGACTGGA
TAGGGCTACCCTGGAGGGT -> AGGGCTACCCTGGAGGGTG
TAGGGCTCGGACCTGGATA -> AGGGCTCGGACCTGGATAA
TAGGGTTGGCTGGACCATA -> AGGGTTGGCTGGACCATAA
TAGGTACGTTATACAGGAC -> AGGTACGTTATACAGGACG
TAGGTCTCGGATCTGGGAA -> AGGTCTCGGATCTGGGAAA
TAGGTTAACATACTGCTAC -> AGGTTAACATACTGCTACC
TAGTAGGTCTCGGATCTGG -> AGTAGGTCTCGGATCTGGG
TAGTCCACGAGCAAAACAC -> AGTCCACGAGCAAAACACG
TAGTCTTTCAACGTAGAAT -> AGTCTTTCAACGTAGAATC
TAGTGGTCGCATGGCGCTC -> AGTGGTCGCATGGCGCTCC
TAGTGTAGTAGGTCTCGGA -> AGTGTAGTAGGTCTCGGAT
TATAAACCAAAACGGAGGC -> ATAAACCAAAACGGAGGCG
TATACACATGAGGTAAATT -> ATACACATGAGGTAAATTC
TATACAGGACGCACACTTC -> ATACAGGACGCACACTTCG
TATACTCCCGTGACCCCCG -> ATACTCCCGTGACCCCCGA
TATAGATCGTAGACACATG -> ATAGATCGTAGACACATGC
TATATCCTAATGTCGAATT -> ATATCCTAATGTCGAATTA
TATATTATGGGGCCCATAT -> ATATTATGGGGCCCATATT
TATCAAGAGAATCACAGCC -> ATCAAGAGAATCACAGCCG
TATCAGGTATTCGCCCTTA -> ATCAGGTATTCGCCCTTAA
TATCCACTATCGCGGATCC -> ATCCACTATCGCGGATCCA
TATCCTAACGCTTTTCGGT -> ATCCTAACGCTTTTCGGTG
TATCCTAATGTCGAATTAT -> ATCCTAATGTCGAATTATT
TATCGCGGATCCAGCTCCC -> ATCGCGGATCCAGCTCCCT
TATCGGTGGGGCATCTGCT -> ATCGGTGGGGCATCTGCTT
TATCGTCAGCCAATTGTGT -> ATCGTCAGCCAATTGTGTC
TATCTCCAACTCGCCGATT -> ATCTCCAACTCGCCGATTT
TATGACATGGGGAACTGTG -> ATGACATGGGGAACTGTGC
TATGCCATCCTTCTGATAG -> ATGCCATCCTTCTGATAGC
TATGCGGCTAACGTGGCGC -> ATGCGGCTAACGTGGCGCT
TATGGGGCCCATATTCTGG -> ATGGGGCCCATATTCTGGG
TATGTTCTGAGCATTGCCT -> ATGTTCTGAGCATTGCCTT
TATTAACAGCACCGGTGAA -> ATTAACAGCACCGGTGAAT
TATTATCTCCAACTCGCCG -> ATTATCTCCAACTCGCCGA
TATTATGGGGCCCATATTC -> ATTATGGGGCCCATATTCT
TATTCGCCCTTAATCAAGG -> ATTCGCCCTTAATCAAGGG
TATTCTGGGTCACTACAGT -> ATTCTGGGTCACTACAGTT
TATTGACACATCTCAAGGT -> ATTGACACATCTCAAGGTC
TATTGCGGTAATAAACTCG -> ATTGCGGTAATAAACTCGG
TATTGGCTGCAGTTTTGTT -> ATTGGCTGCAGTTTTGTTC
TATTGTAGCCCGTCCTATG -> ATTGTAGCCCGTCCTATGA
TATTGTGTTGGAATCTCGC -> ATTGTGTTGGAATCTCGCG
TCAAAAAGCATCTGGCCCC -> CAAAAAGCATCTGGCCCCG
TCAAACGCCCGCCGTTTCA -> CAAACGCCCGCCGTTTCAA
TCAAACTGCTGGCATACGG -> CAAACTGCTGGCATACGGG
TCAAATACATGATTGGTAA -> CAAATACATGATTGGTAAG
TCAAATTTACTGGAAAGCC -> CAAATTTACTGGAAAGCCT
TCAACGTAGAATCCTATTG -> CAACGTAGAATCCTATTGC
TCAACTCCCTGTTCAAATT -> CAACTCCCTGTTCAAATTT
TCAAGAGAATCACAGCCGG -> CAAGAGAATCACAGCCGGG
TCAAGATGTCCCAGGCAGA -> CAAGATGTCCCAGGCAGAG
TCAAGGAAGTCTGAGATTG -> CAAGGAAGTCTGAGATTGG
TCAAGGCGAGATCAGTCGA -> CAAGGCGAGATCAGTCGAG
TCAAGGGCCGTGCATGGAA -> CAAGGGCCGTGCATGGAAA
TCAAGGTCTCATAGCCAAC -> CAAGGTCTCATAGCCAACT
TCAATAGGGCAGAAAATGA -> CAATAGGGCAGAAAATGAC
TCAATCTGGACGAGCCTGA -> CAATCTGGACGAGCCTGAC
TCAATGTAAGGGGCTAGGG -> CAATGTAAGGGGCTAGGGC
TCACAGCCGGGTAGTGGTC -> CACAGCCGGGTAGTGGTCG
TCACGCAAAATCAATAGGG -> CACGCAAAATCAATAGGGC
TCACGTCAGCAACGTATAC -> CACGTCAGCAACGTATACA
TCACTACAGTTGTCAACTC -> CACTACAGTTGTCAACTCC
TCAGAGAGTGAAACAATGG -> CAGAGAGTGAAACAATGGA
TCAGAGTTCAAACTGCTGG -> CAGAGTTCAAACTGCTGGC
TCAGATGCAAGGCCGTCAG -> CAGATGCAAGGCCGTCAGC
TCAGCAACGTATACACATG -> CAGCAACGTATACACATGA
TCAGCAGGTTCTACCGTGC -> CAGCAGGTTCTACCGTGCC
TCAGCCAATTGTGTCCTAT -> CAGCCAATTGTGTCCTATT
TCAGCGGGCAGAAAATGAC -> CAGCGGGCAGAAAATGACT
TCAGGTATTCGCCCTTAAT -> CAGGTATTCGCCCTTAATC
TCAGTATTGTAGCCCGTCC -> CAGTATTGTAGCCCGTCCT
TCAGTCGAGCTTTCTAGCA -> CAGTCGAGCTTTCTAGCAC
TCAGTGCGACCGTCGGATC -> CAGTGCGACCGTCGGATCT
TCAGTTTTGTTCATGGGAC -> CAGTTTTGTTCATGGGACA
TCATACCGTGAGGTCAGTA -> CATACCGTGAGGTCAGTAT
TCATAGCCAACTTAACGTT -> CATAGCCAACTTAACGTTA
TCATAGCTGGCGCGAGCGG -> CATAGCTGGCGCGAGCGGG
TCATCGCCCCATTGAATAC -> CATCGCCCCATTGAATACG
TCATGGGACAACAATTTGA -> CATGGGACAACAATTTGAT
TCATGGGACACTACACAAA -> CATGGGACACTACACAAAC
TCATGGGACAGTTGATAGT -> CATGGGACAGTTGATAGTC
TCATGGGACATATAGATCG -> CATGGGACATATAGATCGT
TCATTAGCCCCGTCAAGGA -> CATTAGCCCCGTCAAGGAA
TCCAACTCGCCGATTTGCT -> CCAACTCGCCGATTTGCTC
TCCAAGAGACAGGAATCTT -> CCAAGAGACAGGAATCTTT
TCCAAGGCGGCCAACATCC -> CCAAGGCGGCCAACATCCA
TCCAATGAGTGTTTTTGAA -> CCAATGAGTGTTTTTGAAG
TCCACGAGCAAAACACGCC -> CCACGAGCAAAACACGCCC
TCCACTATCGCGGATCCAG -> CCACTATCGCGGATCCAGC
TCCAGCTCCCTTGGACACT -> CCAGCTCCCTTGGACACTT
TCCAGGCGACACCGCAGAT -> CCAGGCGACACCGCAGATT
TCCATCCCTGTCGTATGCC -> CCATCCCTGTCGTATGCCA
TCCATCGGGGCAGAAAATG -> CCATCGGGGCAGAAAATGA
TCCCACGTGCCGTAAGCCC -> CCCACGTGCCGTAAGCCCG
TCCCAGGCAGAGGGTTATG -> CCCAGGCAGAGGGTTATGC
TCCCGTGACCCCCGAGCGT -> CCCGTGACCCCCGAGCGTG
TCCCTACCTCGTACCGATG -> CCCTACCTCGTACCGATGC
TCCCTGTCGTATGCCATCC -> CCCTGTCGTATGCCATCCT
TCCCTGTTCAAATTTACTG -> CCCTGTTCAAATTTACTGG
TCCCTTGGACACTTTGAAC -> CCCTTGGACACTTTGAACC
TCCGCGAATGATACGCCGT -> CCGCGAATGATACGCCGTA
TCCGTGTTATCCACTATCG -> CCGTGTTATCCACTATCGC
TCCTAACGCTTTTCGGTGC -> CCTAACGCTTTTCGGTGCA
TCCTAAGAACAAAACCTAG -> CCTAAGAACAAAACCTAGG
TCCTAATGTCGAATTATTA -> CCTAATGTCGAATTATTAT
TCCTATGACATGGGGAACT -> CCTATGACATGGGGAACTG
TCCTATTGCGGTAATAAAC -> CCTATTGCGGTAATAAACT
TCCTATTGTGTTGGAATCT -> CCTATTGTGTTGGAATCTC
TCCTCCGCGAATGATACGC -> CCTCCGCGAATGATACGCC
TCCTGTATCGTCAGCCAAT -> CCTGTATCGTCAGCCAATT
TCCTTACGACATGAAATTT -> CCTTACGACATGAAATTTC
TCCTTCTGATAGCTAGGGC -> CCTTCTGATAGCTAGGGCT
TCGAATTATTATCTCCAAC -> CGAATTATTATCTCCAACT
TCGAGCTTTCTAGCACGAC -> CGAGCTTTCTAGCACGACT
TCGCAAACGAATGTCCCTA -> CGCAAACGAATGTCCCTAC
TCGCATGGCGCTCCATCGG -> CGCATGGCGCTCCATCGGG
TCGCCCCATTGAATACGCT -> CGCCCCATTGAATACGCTC
TCGCCCTTAATCAAGGGCC -> CGCCCTTAATCAAGGGCCG
TCGCCGATTTGCTCTGGAG -> CGCCGATTTGCTCTGGAGG
TCGCCGCGTTTCAAGGCGA -> CGCCGCGTTTCAAGGCGAG
TCGCGGATCCAGCTCCCTT -> CGCGGATCCAGCTCCCTTG
TCGCGGGTGCCTCAGCGGG -> CGCGGGTGCCTCAGCGGGC
TCGGAATTCAAATACATGA -> CGGAATTCAAATACATGAT
TCGGACACGCTAAAGGGCT -> CGGACACGCTAAAGGGCTA
TCGGACCTGGATAATCAGA -> CGGACCTGGATAATCAGAG
TCGGATCTAAAGTGGCAAA -> CGGATCTAAAGTGGCAAAT
TCGGATCTGGGAAAATCGG -> CGGATCTGGGAAAATCGGA
TCGGGGCAGAAAATGACTG -> CGGGGCAGAAAATGACTGG
TCGGGGGACATCAAGATGT -> CGGGGGACATCAAGATGTC
TCGGGTAAATCACGCAAAA -> CGGGTAAATCACGCAAAAT
TCGGGTACCTCTAATGGTC -> CGGGTACCTCTAATGGTCT
TCGGTCCAGGCGACACCGC -> CGGTCCAGGCGACACCGCA
TCGGTGCAGTGGCCAAGCG -> CGGTGCAGTGGCCAAGCGG
TCGGTGGGGCATCTGCTTA -> CGGTGGGGCATCTGCTTAC
TCGTACCGATGCGGCTAGG -> CGTACCGATGCGGCTAGGG
TCGTAGACACATGCACTCA -> CGTAGACACATGCACTCAT
TCGTATGCCATCCTTCTGA -> CGTATGCCATCCTTCTGAT
TCGTCAGCCAATTGTGTCC -> CGTCAGCCAATTGTGTCCT
TCTAAACTCGGGTAAATCA -> CTAAACTCGGGTAAATCAC
TCTAAAGTGGCAAATCATT -> CTAAAGTGGCAAATCATTA
TCTAATGGTCTACGGGACG -> CTAATGGTCTACGGGACGC
TCTACCGTGCCCTCCAAGG -> CTACCGTGCCCTCCAAGGC
TCTACGGGACGCCTTCTGT -> CTACGGGACGCCTTCTGTG
TCTAGCACGACTGGGCTTT -> CTAGCACGACTGGGCTTTT
TCTATAAACCAAAACGGAG -> CTATAAACCAAAACGGAGG
TCTATATTATGGGGCCCAT -> CTATATTATGGGGCCCATA
TCTCAAGGTCTCATAGCCA -> CTCAAGGTCTCATAGCCAA
TCTCACGTCAGCAACGTAT -> CTCACGTCAGCAACGTATA
TCTCATAGCCAACTTAACG -> CTCATAGCCAACTTAACGT
TCTCCAACTCGCCGATTTG -> CTCCAACTCGCCGATTTGC
TCTCCTGTATCGTCAGCCA -> CTCCTGTATCGTCAGCCAA
TCTCGCGGGTGCCTCAGCG -> CTCGCGGGTGCCTCAGCGG
TCTCGGATCTGGGAAAATC -> CTCGGATCTGGGAAAATCG
TCTCTAAACTCGGGTAAAT -> CTCTAAACTCGGGTAAATC
TCTGAGATTGGGCACCACA -> CTGAGATTGGGCACCACAT
TCTGAGCATTGCCTTTGTC -> CTGAGCATTGCCTTTGTCT
TCTGATAGCTAGGGCTACC -> CTGATAGCTAGGGCTACCC
TCTGCTTACTGTGATGTGT -> CTGCTTACTGTGATGTGTC
TCTGGACGAGCCTGACGTA -> CTGGACGAGCCTGACGTAT
TCTGGAGGGACCTCCAAGA -> CTGGAGGGACCTCCAAGAG
TCTGGAGGTGCGTCAATCT -> CTGGAGGTGCGTCAATCTG
TCTGGCCCCGATACCGTGG -> CTGGCCCCGATACCGTGGC
TCTGGGAAAATCGGAATTC -> CTGGGAAAATCGGAATTCA
TCTGGGTCACTACAGTTGT -> CTGGGTCACTACAGTTGTC
TCTGTGTGAATGTTATATC -> CTGTGTGAATGTTATATCC
TCTTGGTCGGACACGCTAA -> CTTGGTCGGACACGCTAAA
TCTTTCAACGTAGAATCCT -> CTTTCAACGTAGAATCCTA
TCTTTGTGGGCTATTATCG -> CTTTGTGGGCTATTATCGT
TGAAACAATGGAAAACTCG -> GAAACAATGGAAAACTCGG
TGAAACTTAGTGTAGTAGG -> GAAACTTAGTGTAGTAGGT
TGAAATTTCGCAAACGAAT -> GAAATTTCGCAAACGAATG
TGAACCCTGACATGCAGAT -> GAACCCTGACATGCAGATG
TGAACGGGATCCAATGAGT -> GAACGGGATCCAATGAGTG
TGAAGGACGTTGAGCCCCT -> GAAGGACGTTGAGCCCCTA
TGAAGTAGCGCCAGTTGGA -> GAAGTAGCGCCAGTTGGAC
TGAAGTTCCGTGTTATCCA -> GAAGTTCCGTGTTATCCAC
TGAATACGCTCAGAGTTCA -> GAATACGCTCAGAGTTCAA
TGAATAGCGGGGGATATCG -> GAATAGCGGGGGATATCGG
TGAATGTGGGTGTTCAAAA -> GAATGTGGGTGTTCAAAAA
TGAATGTTATATCCTAATG -> GAATGTTATATCCTAATGT
TGACACATCTCAAGGTCTC -> GACACATCTCAAGGTCTCA
TGACATGCAGATGGGCAGA -> GACATGCAGATGGGCAGAA
TGACATGGGGAACTGTGCC -> GACATGGGGAACTGTGCCG
TGACCCCCGAGCGTGGAGC -> GACCCCCGAGCGTGGAGCG
TGACGCGGTAACCACATCA -> GACGCGGTAACCACATCAA
TGACGTATTAACAGCACCG -> GACGTATTAACAGCACCGG
TGACTGGAAGTATTGGCTG -> GACTGGAAGTATTGGCTGC
TGACTGGACGACTGGCTGC -> GACTGGACGACTGGCTGCC
TGACTGGAGTGCCCCCTTT -> GACTGGAGTGCCCCCTTTC
TGACTGGATGATGGGAGAA -> GACTGGATGATGGGAGAAC
TGAGATTGGGCACCACATA -> GAGATTGGGCACCACATAA
TGAGCATTGCCTTTGTCTC -> GAGCATTGCCTTTGTCTCC
TGAGCCCCTACAAGTCTAT -> GAGCCCCTACAAGTCTATA
TGAGGTAAATTCCTAAGAA -> GAGGTAAATTCCTAAGAAC
TGAGGTCAGTATTGTAGCC -> GAGGTCAGTATTGTAGCCC
TGAGTGTTTTTGAAGGACG -> GAGTGTTTTTGAAGGACGT
TGATAATAGGATATCAGGT -> GATAATAGGATATCAGGTA
TGATACGCCGTATTGACAC -> GATACGCCGTATTGACACA
TGATAGCTAGGGCTACCCT -> GATAGCTAGGGCTACCCTG
TGATAGTCTTTCAACGTAG -> GATAGTCTTTCAACGTAGA
TGATGGGAGAACAGTTTTG -> GATGGGAGAACAGTTTTGT
TGATGTGTCAGATGCAAGG -> GATGTGTCAGATGCAAGGC
TGATTAACCATAACCAGCA -> GATTAACCATAACCAGCAA
TGATTGGTAAGCGTCATCG -> GATTGGTAAGCGTCATCGC
TGATTTAGAGAAATGTATC -> GATTTAGAGAAATGTATCC
TGCAAGGCCGTCAGCAGGT -> GCAAGGCCGTCAGCAGGTT
TGCACTCATAGCTGGCGCG -> GCACTCATAGCTGGCGCGA
TGCAGATGGGCAGAAAATG -> GCAGATGGGCAGAAAATGA
TGCAGTGGCCAAGCGGGGG -> GCAGTGGCCAAGCGGGGGG
TGCAGTTTTGTTCATGGGA -> GCAGTTTTGTTCATGGGAC
TGCATGGAAAGCATGCGAC -> GCATGGAAAGCATGCGACA
TGCCAGTTTTGTTCATGGG -> GCCAGTTTTGTTCATGGGA
TGCCATCCTTCTGATAGCT -> GCCATCCTTCTGATAGCTA
TGCCCAGGTACAATCCTTA -> GCCCAGGTACAATCCTTAC
TGCCCCCTTTCAGTTTTGT -> GCCCCCTTTCAGTTTTGTT
TGCCCTCCAAGGCGGCCAA -> GCCCTCCAAGGCGGCCAAC
TGCCCTTAATTGACGCGGT -> GCCCTTAATTGACGCGGTA
TGCCGTAAGCCCGCAGGTA -> GCCGTAAGCCCGCAGGTAG
TGCCGTGCCTGGGAGGGGC -> GCCGTGCCTGGGAGGGGCT
TGCCTCAGCGGGCAGAAAA -> GCCTCAGCGGGCAGAAAAT
TGCCTGGGAGGGGCTCTCA -> GCCTGGGAGGGGCTCTCAC
TGCCTTTGTCTCCTGTATC -> GCCTTTGTCTCCTGTATCG
TGCGAAAGACCACTGAACG -> GCGAAAGACCACTGAACGG
TGCGACAAGCACAGCCTTG -> GCGACAAGCACAGCCTTGC
TGCGACCGTCGGATCTAAA -> GCGACCGTCGGATCTAAAG
TGCGGCTAACGTGGCGCTA -> GCGGCTAACGTGGCGCTAC
TGCGGCTAGGGTTGGCTGG -> GCGGCTAGGGTTGGCTGGA
TGCGGTAATAAACTCGGGT -> GCGGTAATAAACTCGGGTA
TGCGTCAATCTGGACGAGC -> GCGTCAATCTGGACGAGCC
TGCGTCTCTAAACTCGGGT -> GCGTCTCTAAACTCGGGTA
TGCTACCGATGAAGTAGCG -> GCTACCGATGAAGTAGCGC
TGCTCTGGAGGTGCGTCAA -> GCTCTGGAGGTGCGTCAAT
TGCTGGCATACGGGATTGA -> GCTGGCATACGGGATTGAT
TGCTTACTGTGATGTGTCA -> GCTTACTGTGATGTGTCAG
TGGAAAACTCGGTCCAGGC -> GGAAAACTCGGTCCAGGCG
TGGAAAGCATGCGACAAGC -> GGAAAGCATGCGACAAGCA
TGGAAAGCCTCCTCCGCGA -> GGAAAGCCTCCTCCGCGAA
TGGAAGTATTGGCTGCAGT -> GGAAGTATTGGCTGCAGTT
TGGAATCTCGCGGGTGCCT -> GGAATCTCGCGGGTGCCTC
TGGACACTTTGAACCCTGA -> GGACACTTTGAACCCTGAC
TGGACCATAAGGCGTTACG -> GGACCATAAGGCGTTACGG
TGGACCTCCCACGTGCCGT -> GGACCTCCCACGTGCCGTA
TGGACGACTGGCTGCCAGT -> GGACGACTGGCTGCCAGTT
TGGACGAGCCTGACGTATT -> GGACGAGCCTGACGTATTA
TGGAGCGTGCCCAGGTACA -> GGAGCGTGCCCAGGTACAA
TGGAGGGACCTCCAAGAGA -> GGAGGGACCTCCAAGAGAC
TGGAGGGTGATTAACCATA -> GGAGGGTGATTAACCATAA
TGGAGGTGCGTCAATCTGG -> GGAGGTGCGTCAATCTGGA
TGGAGTGCCCCCTTTCAGT -> GGAGTGCCCCCTTTCAGTT
TGGATAATCAGAGAGTGAA -> GGATAATCAGAGAGTGAAA
TGGATGATGGGAGAACAGT -> GGATGATGGGAGAACAGTT
TGGCAAATCATTAGCCCCG -> GGCAAATCATTAGCCCCGT
TGGCACAGAAAAACTGCGA -> GGCACAGAAAAACTGCGAA
TGGCATACGGGATTGATAA -> GGCATACGGGATTGATAAT
TGGCCAAGCGGGGGGCTTG -> GGCCAAGCGGGGGGCTTGA
TGGCCCCGATACCGTGGCT -> GGCCCCGATACCGTGGCTG
TGGCGCGAGCGGGAGTACC -> GGCGCGAGCGGGAGTACCC
TGGCGCTACTAGGTTAACA -> GGCGCTACTAGGTTAACAT
TGGCGCTCCATCGGGGCAG -> GGCGCTCCATCGGGGCAGA
TGGCTGCAGTTTTGTTCAT -> GGCTGCAGTTTTGTTCATG
TGGCTGCCAGTTTTGTTCA -> GGCTGCCAGTTTTGTTCAT
TGGCTGCCCTTAATTGACG -> GGCTGCCCTTAATTGACGC
TGGCTGGACCATAAGGCGT -> GGCTGGACCATAAGGCGTT
TGGGAAAATCGGAATTCAA -> GGGAAAATCGGAATTCAAA
TGGGACAACAATTTGATTT -> GGGACAACAATTTGATTTA
TGGGACACTACACAAACGG -> GGGACACTACACAAACGGC
TGGGACAGTTGATAGTCTT -> GGGACAGTTGATAGTCTTT
TGGGACATATAGATCGTAG -> GGGACATATAGATCGTAGA
TGGGAGAACAGTTTTGTTC -> GGGAGAACAGTTTTGTTCA
TGGGAGGGGCTCTCACGTC -> GGGAGGGGCTCTCACGTCA
TGGGCAAAGTTGAAGTTCC -> GGGCAAAGTTGAAGTTCCG
TGGGCAAGATACGAAAGTT -> GGGCAAGATACGAAAGTTG
TGGGCACCACATAAGGCGC -> GGGCACCACATAAGGCGCG
TGGGCAGAAAATGACTGGA -> GGGCAGAAAATGACTGGAT
TGGGCTTTTAGCATAGTCC -> GGGCTTTTAGCATAGTCCA
TGGGGAACTGTGCCGTGCC -> GGGGAACTGTGCCGTGCCT
TGGGGCATCTGCTTACTGT -> GGGGCATCTGCTTACTGTG
TGGGGCCCATATTCTGGGT -> GGGGCCCATATTCTGGGTC
TGGGTCACTACAGTTGTCA -> GGGTCACTACAGTTGTCAA
TGGGTGTTCAAAAAGCATC -> GGGTGTTCAAAAAGCATCT
TGGTAAGCGTCATCGCCCC -> GGTAAGCGTCATCGCCCCA
TGGTACCTATACTCCCGTG -> GGTACCTATACTCCCGTGA
TGGTCATACCGTGAGGTCA -> GGTCATACCGTGAGGTCAG
TGGTCGCATGGCGCTCCAT -> GGTCGCATGGCGCTCCATC
TGGTCGGACACGCTAAAGG -> GGTCGGACACGCTAAAGGG
TGGTCTACGGGACGCCTTC -> GGTCTACGGGACGCCTTCT
TGTAAGGGGCTAGGGCTCG -> GTAAGGGGCTAGGGCTCGG
TGTAGCCCGTCCTATGACA -> GTAGCCCGTCCTATGACAT
TGTAGTAGGTCTCGGATCT -> GTAGTAGGTCTCGGATCTG
TGTATCCTAACGCTTTTCG -> GTATCCTAACGCTTTTCGG
TGTATCGTCAGCCAATTGT -> GTATCGTCAGCCAATTGTG
TGTCAACTCCCTGTTCAAA -> GTCAACTCCCTGTTCAAAT
TGTCAGATGCAAGGCCGTC -> GTCAGATGCAAGGCCGTCA
TGTCCCAGGCAGAGGGTTA -> GTCCCAGGCAGAGGGTTAT
TGTCCCTACCTCGTACCGA -> GTCCCTACCTCGTACCGAT
TGTCCTATTGTGTTGGAAT -> GTCCTATTGTGTTGGAATC
TGTCGAATTATTATCTCCA -> GTCGAATTATTATCTCCAA
TGTCGTATGCCATCCTTCT -> GTCGTATGCCATCCTTCTG
TGTCTCCTGTATCGTCAGC -> GTCTCCTGTATCGTCAGCC
TGTGAATGTTATATCCTAA -> GTGAATGTTATATCCTAAT
TGTGATGTGTCAGATGCAA -> GTGATGTGTCAGATGCAAG
TGTGCCGTGCCTGGGAGGG -> GTGCCGTGCCTGGGAGGGG
TGTGGGTGTTCAAAAAGCA -> GTGGGTGTTCAAAAAGCAT
TGTGTCAGATGCAAGGCCG -> GTGTCAGATGCAAGGCCGT
TGTGTCCTATTGTGTTGGA -> GTGTCCTATTGTGTTGGAA
TGTGTGAATGTTATATCCT -> GTGTGAATGTTATATCCTA
TGTGTTGGAATCTCGCGGG -> GTGTTGGAATCTCGCGGGT
TGTTATATCCTAATGTCGA -> GTTATATCCTAATGTCGAA
TGTTATCCACTATCGCGGA -> GTTATCCACTATCGCGGAT
TGTTCAAAAAGCATCTGGC -> GTTCAAAAAGCATCTGGCC
TGTTCAAATTTACTGGAAA -> GTTCAAATTTACTGGAAAG
TGTTCATGGGACAACAATT -> GTTCATGGGACAACAATTT
TGTTCATGGGACACTACAC -> GTTCATGGGACACTACACA
TGTTCATGGGACAGTTGAT -> GTTCATGGGACAGTTGATA
TGTTCATGGGACATATAGA -> GTTCATGGGACATATAGAT
TGTTCTGAGCATTGCCTTT -> GTTCTGAGCATTGCCTTTG
TGTTGGAATCTCGCGGGTG -> GTTGGAATCTCGCGGGTGC
TGTTTTTGAAGGACGTTGA -> GTTTTTGAAGGACGTTGAG
TTAACACCACGGCAGTCAG -> TAACACCACGGCAGTCAGT
TTAACAGCACCGGTGAATA -> TAACAGCACCGGTGAATAG
TTAACATACTGCTACCGAT -> TAACATACTGCTACCGATG
TTAACCATAACCAGCAAGG -> TAACCATAACCAGCAAGGG
TTAACGTTATCAAGAGAAT -> TAACGTTATCAAGAGAATC
TTAATCAAGGGCCGTGCAT -> TAATCAAGGGCCGTGCATG
TTAATTGACGCGGTAACCA -> TAATTGACGCGGTAACCAC
TTACGACATGAAATTTCGC -> TACGACATGAAATTTCGCA
TTACGGATTAACACCACGG -> TACGGATTAACACCACGGC
TTACTGGAAAGCCTCCTCC -> TACTGGAAAGCCTCCTCCG
TTACTGTGATGTGTCAGAT -> TACTGTGATGTGTCAGATG
TTAGAGAAATGTATCCTAA -> TAGAGAAATGTATCCTAAC
TTAGCATAGTCCACGAGCA -> TAGCATAGTCCACGAGCAA
TTAGCCCCGTCAAGGAAGT -> TAGCCCCGTCAAGGAAGTC
TTAGTGTAGTAGGTCTCGG -> TAGTGTAGTAGGTCTCGGA
TTATACAGGACGCACACTT -> TATACAGGACGCACACTTC
TTATATCCTAATGTCGAAT -> TATATCCTAATGTCGAATT
TTATCAAGAGAATCACAGC -> TATCAAGAGAATCACAGCC
TTATCCACTATCGCGGATC -> TATCCACTATCGCGGATCC
TTATCTCCAACTCGCCGAT -> TATCTCCAACTCGCCGATT
TTATGCGGCTAACGTGGCG -> TATGCGGCTAACGTGGCGC
TTATGGGGCCCATATTCTG -> TATGGGGCCCATATTCTGG
TTATTATCTCCAACTCGCC -> TATTATCTCCAACTCGCCG
TTCAAAAAGCATCTGGCCC -> TCAAAAAGCATCTGGCCCC
TTCAAACTGCTGGCATACG -> TCAAACTGCTGGCATACGG
TTCAAATACATGATTGGTA -> TCAAATACATGATTGGTAA
TTCAAATTTACTGGAAAGC -> TCAAATTTACTGGAAAGCC
TTCAACGTAGAATCCTATT -> TCAACGTAGAATCCTATTG
TTCAAGGCGAGATCAGTCG -> TCAAGGCGAGATCAGTCGA
TTCAATGTAAGGGGCTAGG -> TCAATGTAAGGGGCTAGGG
TTCAGTTTTGTTCATGGGA -> TCAGTTTTGTTCATGGGAC
TTCATGGGACAACAATTTG -> TCATGGGACAACAATTTGA
TTCATGGGACACTACACAA -> TCATGGGACACTACACAAA
TTCATGGGACAGTTGATAG -> TCATGGGACAGTTGATAGT
TTCATGGGACATATAGATC -> TCATGGGACATATAGATCG
TTCCGTGTTATCCACTATC -> TCCGTGTTATCCACTATCG
TTCCTAAGAACAAAACCTA -> TCCTAAGAACAAAACCTAG
TTCGCAAACGAATGTCCCT -> TCGCAAACGAATGTCCCTA
TTCGCCCTTAATCAAGGGC -> TCGCCCTTAATCAAGGGCC
TTCGGGGGACATCAAGATG -> TCGGGGGACATCAAGATGT
TTCGGTGCAGTGGCCAAGC -> TCGGTGCAGTGGCCAAGCG
TTCTACCGTGCCCTCCAAG -> TCTACCGTGCCCTCCAAGG
TTCTAGCACGACTGGGCTT -> TCTAGCACGACTGGGCTTT
TTCTGAGCATTGCCTTTGT -> TCTGAGCATTGCCTTTGTC
TTCTGATAGCTAGGGCTAC -> TCTGATAGCTAGGGCTACC
TTCTGGGTCACTACAGTTG -> TCTGGGTCACTACAGTTGT
TTCTGTGTGAATGTTATAT -> TCTGTGTGAATGTTATATC
TTCTTGGTCGGACACGCTA -> TCTTGGTCGGACACGCTAA
TTGAAACTTAGTGTAGTAG -> TGAAACTTAGTGTAGTAGG
TTGAACCCTGACATGCAGA -> TGAACCCTGACATGCAGAT
TTGAAGGACGTTGAGCCCC -> TGAAGGACGTTGAGCCCCT
TTGAAGTTCCGTGTTATCC -> TGAAGTTCCGTGTTATCCA
TTGAATACGCTCAGAGTTC -> TGAATACGCTCAGAGTTCA
TTGAATGTGGGTGTTCAAA -> TGAATGTGGGTGTTCAAAA
TTGACACATCTCAAGGTCT -> TGACACATCTCAAGGTCTC
TTGACGCGGTAACCACATC -> TGACGCGGTAACCACATCA
TTGAGCCCCTACAAGTCTA -> TGAGCCCCTACAAGTCTAT
TTGATAATAGGATATCAGG -> TGATAATAGGATATCAGGT
TTGATAGTCTTTCAACGTA -> TGATAGTCTTTCAACGTAG
TTGATTTAGAGAAATGTAT -> TGATTTAGAGAAATGTATC
TTGCCTTTGTCTCCTGTAT -> TGCCTTTGTCTCCTGTATC
TTGCGGTAATAAACTCGGG -> TGCGGTAATAAACTCGGGT
TTGCGTCTCTAAACTCGGG -> TGCGTCTCTAAACTCGGGT
TTGCTCTGGAGGTGCGTCA -> TGCTCTGGAGGTGCGTCAA
TTGGAATCTCGCGGGTGCC -> TGGAATCTCGCGGGTGCCT
TTGGACACTTTGAACCCTG -> TGGACACTTTGAACCCTGA
TTGGACCTCCCACGTGCCG -> TGGACCTCCCACGTGCCGT
TTGGCACAGAAAAACTGCG -> TGGCACAGAAAAACTGCGA
TTGGCTGCAGTTTTGTTCA -> TGGCTGCAGTTTTGTTCAT
TTGGCTGGACCATAAGGCG -> TGGCTGGACCATAAGGCGT
TTGGGCACCACATAAGGCG -> TGGGCACCACATAAGGCGC
TTGGTAAGCGTCATCGCCC -> TGGTAAGCGTCATCGCCCC
TTGGTCATACCGTGAGGTC -> TGGTCATACCGTGAGGTCA
TTGGTCGGACACGCTAAAG -> TGGTCGGACACGCTAAAGG
TTGTAGCCCGTCCTATGAC -> TGTAGCCCGTCCTATGACA
TTGTCAACTCCCTGTTCAA -> TGTCAACTCCCTGTTCAAA
TTGTCTCCTGTATCGTCAG -> TGTCTCCTGTATCGTCAGC
TTGTGTCCTATTGTGTTGG -> TGTGTCCTATTGTGTTGGA
TTGTGTTGGAATCTCGCGG -> TGTGTTGGAATCTCGCGGG
TTGTTCATGGGACAACAAT -> TGTTCATGGGACAACAATT
TTGTTCATGGGACACTACA -> TGTTCATGGGACACTACAC
TTGTTCATGGGACAGTTGA -> TGTTCATGGGACAGTTGAT
TTGTTCATGGGACATATAG -> TGTTCATGGGACATATAGA
TTTACTGGAAAGCCTCCTC -> TTACTGGAAAGCCTCCTCC
TTTAGAGAAATGTATCCTA -> TTAGAGAAATGTATCCTAA
TTTAGCATAGTCCACGAGC -> TTAGCATAGTCCACGAGCA
TTTCAACGTAGAATCCTAT -> TTCAACGTAGAATCCTATT
TTTCAAGGCGAGATCAGTC -> TTCAAGGCGAGATCAGTCG
TTTCAATGTAAGGGGCTAG -> TTCAATGTAAGGGGCTAGG
TTTCAGTTTTGTTCATGGG -> TTCAGTTTTGTTCATGGGA
TTTCGCAAACGAATGTCCC -> TTCGCAAACGAATGTCCCT
TTTCGGTGCAGTGGCCAAG -> TTCGGTGCAGTGGCCAAGC
TTTCTAGCACGACTGGGCT -> TTCTAGCACGACTGGGCTT
TTTGAACCCTGACATGCAG -> TTGAACCCTGACATGCAGA
TTTGAAGGACGTTGAGCCC -> TTGAAGGACGTTGAGCCCC
TTTGATTTAGAGAAATGTA -> TTGATTTAGAGAAATGTAT
TTTGCTCTGGAGGTGCGTC -> TTGCTCTGGAGGTGCGTCA
TTTGGTCATACCGTGAGGT -> TTGGTCATACCGTGAGGTC
TTTGTCTCCTGTATCGTCA -> TTGTCTCCTGTATCGTCAG
TTTGTGGGCTATTATCGTC -> TTGTGGGCTATTATCGTCG
TTTGTTCATGGGACAACAA -> TTGTTCATGGGACAACAAT
TTTGTTCATGGGACACTAC -> TTGTTCATGGGACACTACA
TTTGTTCATGGGACAGTTG -> TTGTTCATGGGACAGTTGA
TTTGTTCATGGGACATATA -> TTGTTCATGGGACATATAG
TTTTAGCATAGTCCACGAG -> TTTAGCATAGTCCACGAGC
TTTTCGGTGCAGTGGCCAA -> TTTCGGTGCAGTGGCCAAG
TTTTGAAGGACGTTGAGCC -> TTTGAAGGACGTTGAGCCC
TTTTGTTCATGGGACAACA -> TTTGTTCATGGGACAACAA
TTTTGTTCATGGGACACTA -> TTTGTTCATGGGACACTAC
TTTTGTTCATGGGACAGTT -> TTTGTTCATGGGACAGTTG
TTTTGTTCATGGGACATAT -> TTTGTTCATGGGACATATA
TTTTTGAAGGACGTTGAGC -> TTTTGAAGGACGTTGAGCC
